PLOTTITLE XLEAST SLOPEY YUNIT	The PLOTTITLE has grown since XLEAST by at least SLOPEY YUNIT
PLOTTITLE XHIGHEST YLABEL COUNT XLABEL XLEAST	This chart shows the PLOTTITLE . We can see that XHIGHEST have the highest YLABEL out of the COUNT XLABEL and XLEAST has the lowest .
T1AB XLABEL XHIGHEST XLABEL T1AY YUNIT YHIGHESTAPPROX YMAG XLEAST COUNT XLABEL YUNIT YLEASTAPPROX YMAG T1AY	In T1AB , the XLABEL of XHIGHEST was the biggest XLABEL on T1AY , spending around YUNIT YHIGHESTAPPROX YMAG . XLEAST was the lowest of the COUNT XLABELs naYMAGed , spending only around YUNIT YLEASTAPPROX YMAG on T1AY .
XHIGHEST MULHIGHESTSECOND XSECOND T1AX T1AY XLEAST YLEAST YUNIT T1AX T1AY	The chat shows that XHIGHEST is MULHIGHESTSECOND as likely as XSECOND to T1AX T1AY . It also shows that XLEAST is only YLEAST YUNIT likely to T1AX T1AY .
YLABEL XHIGHEST XSECOND XLABEL YLABEL XLEAST YLEAST YUNIT XFOURTH YFOURTH YUNIT XTHIRD YTHIRD YUNIT	The chart shows how YLABEL is highest in the XHIGHEST and XSECOND XLABEL . The lowest YLABEL are in XLEAST with just YLEAST YUNIT , followed by XFOURTH with YFOURTH YUNIT and XTHIRD with YTHIRD YUNIT
PLOTTITLE XLEAST YUNIT YLEASTAPPROX YMAG T1AY YLABEL XSECOND YUNIT YSECONDAPPROX YMAG XTHIRD YUNIT YTHIRDAPPROX YMAG XHIGHEST YUNIT YHIGHESTAPPROX YMAG	The chart shows the PLOTTITLE . \\n In XLEAST YUNIT YLEASTAPPROX YMAG was spent on T1AY . This is the lowest YLABEL . In XSECOND the spending was YUNIT YSECONDAPPROX YMAG , in XTHIRD it was YUNIT YTHIRDAPPROX YMAG and XHIGHEST was the highest with YUNIT YHIGHESTAPPROX YMAG .
PLOTTITLE YSECOND YUNIT YLABEL XSECOND YHIGHEST YUNIT XHIGHEST XTHIRD YTHIRD YUNIT XFOURTH YFOURTH YUNIT XLEAST YLEASTAPPROX YUNIT	PLOTTITLE = There is a YSECOND YUNIT YLABEL in XSECOND and YHIGHEST YUNIT in XHIGHEST . In XTHIRD this is YTHIRD YUNIT . However in XFOURTH it is YFOURTH YUNIT and XLEAST just YLEASTAPPROX YUNIT . This seems almost opposite to what I would expect .
PLOTTITLE XSTART XLABEL XLEAST XEND XHIGHEST YLABEL XHIGHEST YHIGHEST YMAG YSECOND YMAG XSECOND XTHIRD YLABEL YTHIRD YMAG XLEAST YLEAST YMAG SLOPEX XLABEL SLOPEY YMAG	This graph represents the PLOTTITLE XSTART the XLABEL XLEAST XEND XHIGHEST . The highest YLABEL is in XHIGHEST with YHIGHEST YMAG , this is above the YSECOND YMAG in XSECOND . In XTHIRD the YLABEL was YTHIRD YMAG and in XLEAST YLEAST YMAG . This shows an increase every SLOPEX XLABEL of SLOPEX YMAG .
PLOTTITLE YLABEL YHIGHEST YUNIT YLABEL T1AX XHIGHEST YSECOND YUNIT XSECOND YLEAST YUNIT XLEAST	This chart shows PLOTTITLE by YLABEL . YHIGHEST YUNIT of YLABEL are T1AX by XHIGHEST ; YSECOND YUNIT are XSECOND and YLEAST YUNIT are due to XLEAST . Unfortunately the chart doesn't show the cases where more than one of these causes may have played an influence on why someone is obese .
COUNT XLABEL T1AY T1AB XLABEL XHIGHEST YHIGHESTAPPROX YUNIT XLEAST YLEASTAPPROX YUNIT XSECOND YSECONDAPPROX YUNIT	There are COUNT XLABEL represented as contributing to T1AY in T1AB . The main XLABEL represented is XHIGHEST , at YHIGHESTAPPROX YUNIT with XLEAST making up YLEASTAPPROX YUNIT and XSECOND YSECONDAPPROX YUNIT .
PLOTTITLE XLABEL XLEAST YLABEL YLEASTAPPROX YUNIT XFOURTH YFOURTHAPPROX YUNIT XTHIRD YTHIRD YUNIT XLABEL XSECOND YSECOND YUNIT XLABEL XHIGHEST YHIGHEST YUNIT	This chart shows the PLOTTITLE . According to the chart , XLABEL XLEAST spend the least YLABEL with YLEASTAPPROX YUNIT , closely followed by XFOURTH who spend YFOURTHAPPROX YUNIT . Then XTHIRD who spend YTHIRD YUNIT . After that it ' s XLABEL XSECOND who spend YSECOND YUNIT and then XLABEL XHIGHEST , who spend YHIGHEST YUNIT .
YLABEL XLABEL T1AY T1AB XHIGHEST YHIGHESTAPPROX YMAG YUNIT XLEAST YLEAST YMAG YUNIT	The graph shows us the YLABEL various XLABEL spent on T1AY in T1AB . XHIGHEST spent the most at just over YHIGHESTAPPROX YMAG YUNIT with XLEAST spending the least at YLEAST YMAG YUNIT .
PLOTTITLE XLABEL XHIGHEST XSECOND XTHIRD XLEAST	Here is a chart about the PLOTTITLE . The most common XLABEL is XHIGHEST , followed by XSECOND . The third most popular is XTHIRD followed by XLEAST .
T1AY T1AX XHIGHEST YHIGHEST YLABEL YSECOND YUNIT XSECOND YLEAST YUNIT XLEAST MULTHIRDLEAST XTHIRD	Most T1AY spend their T1AX XHIGHEST at YHIGHEST YLABEL doing this compared with YSECOND YLABEL XSECOND . Only YLEAST YLABEL XLEAST with MULTHIRDLEAST that XTHIRD .
T1AY T1AY YHIGHEST YUNIT XHIGHEST T1AB YLEASTAPPROX YUNIT T1AY XLEAST	T1AY are T1AY at YHIGHEST YUNIT for XHIGHEST in T1AB , whereas only just over YLEASTAPPROX YUNIT are T1AY in XLEAST .
YLABEL T1AB YUNIT YHIGHESTAPPROX XHIGHEST YLABEL YUNIT YLEASTAPPROX XLEAST	The YLABEL of T1AB have declined as the week has progressed according to the chart . From a value of YUNIT YHIGHESTAPPROX on XHIGHEST , the YLABEL closed at YUNIT YLEASTAPPROX on XLEAST .
PLOTTITLE YUNIT T1AY T1AX YUNIT YTHIRDAPPROX XLABEL XHIGHEST YLABEL YUNIT YHIGHESTAPPROX XLEAST YLABEL YUNIT YLEASTAPPROX	This graph shows PLOTTITLE , in YUNIT . The graph shows that the T1AY started the T1AX at just over YUNIT YTHIRDAPPROX , the best XLABEL was WednesXLABEL where the YLABEL were approx. YUNIT YHIGHESTAPPROX and the worst was FriXLABEL were the YLABEL dropped significantly to just under YUNIT YLEASTAPPROX .
YLABEL T1AB YSECOND XSECOND YHIGHEST XHIGHEST XTHIRD YTHIRD YLEAST XLEAST XFOURTH YFOURTH YUNIT	The YLABEL at the T1AB started at YSECOND in XSECOND , this increased to YHIGHEST in XHIGHEST . In XTHIRD this dropped back to YTHIRD and then a further drop to YLEAST in XLEAST . However in XFOURTH there was a slight increase to YFOURTH YUNIT .
XHIGHEST XLABEL YHIGHEST YUNIT YLABEL MULHIGHESTSECOND XLABEL XSECOND YSECOND YUNIT MULHIGHESTLEAST XLEAST YLEAST YUNIT YLABEL	XHIGHEST is the highest XLABEL with YHIGHEST YUNIT of YLABEL . It is MULHIGHESTSECOND the next highest XLABEL - XSECOND on YSECOND YUNIT and MULHIGHESTLEAST XLEAST which only XLABELs YLEAST YUNIT of YLABEL .
YLABEL T1AB YSECOND XSECOND YHIGHEST XHIGHEST XHIGHEST YLABEL GRTHIRDLEAST YTHIRD XTHIRD YLEAST XLEAST YFOURTH XFOURTH	The YLABEL at the T1AB rose from YSECOND in XSECOND to YHIGHEST in XHIGHEST . Since XHIGHEST , the YLABEL declined during the GRTHIRDLEAST to YTHIRD in XTHIRD and YLEAST in XLEAST before rising again to YFOURTH in XFOURTH .
GRYSECONDLEAST T1AB T1AX GRSECONDLEAST YLEASTAPPROX YUNIT T1AX XLEAST YSECONDAPPROX YUNIT XSECOND	This chart shows the GRYSECONDLEAST in T1AB is T1AX by GRSECONDLEAST , with YLEASTAPPROX YUNIT T1AX by XLEAST and YSECONDAPPROX YUNIT due to a XSECOND .
PLOTTITLE XSTART XHIGHEST XEND XFIFTH INTERVAL XLABEL YLABEL YHIGHESTAPPROX YUNIT XHIGHEST YLEASTAPPROX YUNIT XLEAST XFIFTH YLABEL YFIFTHAPPROX YUNIT	The graph shows the PLOTTITLE XSTART XHIGHEST XEND XFIFTH . Data has been recorded every INTERVAL XLABEL . The YLABEL has reduced significantly XSTART YHIGHESTAPPROX YUNIT in XHIGHEST XEND YLEASTAPPROX YUNIT in XLEAST . From 2015-XFIFTH the YLABEL increased slightly XEND YFIFTHAPPROX YUNIT .
PLOTTITLE XSTART XLABEL XSECOND XEND XLEAST XLABEL XSECOND YSECONDAPPROX YMAG YHIGHESTAPPROX YMAG XHIGHEST XTHIRD YTHIRDAPPROX YMAG XLEAST	Here is a chart based on PLOTTITLE XSTART the XLABEL of XSECOND XEND XLEAST . \\n In the XLABEL XSECOND it was holding at YSECONDAPPROX YMAG , rising to just over YSECONDAPPROX YMAG in XHIGHEST . From XTHIRD it dropped dramatically to under YTHIRDAPPROX YMAG and again in XLEAST .
PLOTTITLE XSTART XHIGHEST XEND XLEAST YHIGHEST YUNIT XHIGHEST YSECOND XSECOND XTHIRD YTHIRD YUNIT YLABEL XFOURTH YFOURTH XLEAST YLABEL YLEAST	This graph shows the PLOTTITLE XSTART XHIGHEST XEND XLEAST . There were YHIGHEST YUNIT in XHIGHEST , dropping to YSECOND in XSECOND . In XTHIRD there was another decrease with YTHIRD YUNIT . The YLABEL in XFOURTH dropped slightly to YFOURTH XEND there was another drop in XLEAST when the YLABEL was YLEAST .
PLOTTITLE T1AY T1AX XHIGHEST YHIGHESTAPPROX YUNIT YSECOND YUNIT XSECOND YTHIRDAPPROX YUNIT XTHIRD YLEAST YUNIT T1AX XLEAST	This chart shows PLOTTITLE . According to the chart , most T1AY spend their T1AX XHIGHEST - YHIGHESTAPPROX YUNIT of them . Around YSECOND YUNIT of them XSECOND . YTHIRDAPPROX YUNIT of them XTHIRD and just YLEAST YUNIT spend their T1AX XLEAST .
PLOTTITLE XHIGHEST YUNIT YHIGHEST XSECOND YSECOND XTHIRD YTHIRD GRLEASTLEAST GRYLEASTLEAST	This graph shows the PLOTTITLE . XHIGHEST has the highest YUNIT with YHIGHEST , XSECOND is next with YSECOND , XTHIRD follows with YTHIRD and then GRLEASTLEAST have GRYLEASTLEAST each .
SLOPEX XLABEL T1AY YLABEL T1AB SLOPEY YUNIT SLOPEX	The chart shows every SLOPEX XLABEL the T1AY YLABEL of T1AB is rising by about SLOPEY YUNIT a SLOPEX .
PLOTTITLE XHIGHEST YLABEL YUNIT	This chart shows the PLOTTITLE . It shows the XHIGHEST spent the most YLABEL , with a decrease in YUNIT for each acending age group .
PLOTTITLE XHIGHEST YHIGHESTAPPROX YUNIT T1AB T1AY YSECOND YUNIT XSECOND YTHIRDAPPROX YUNIT XTHIRD YFOURTHAPPROX YUNIT XFOURTH YLEASTAPPROX YUNIT XLEAST YFIFTHAPPROX YUNIT XFIFTH	This chart describes the PLOTTITLE . XHIGHEST , almost YHIGHESTAPPROX YUNIT of the T1AB were T1AY . This dropped to YSECOND YUNIT XSECOND ; YTHIRDAPPROX YUNIT XTHIRD ; YFOURTHAPPROX YUNIT 2005-200YTHIRDAPPROX ; YLEASTAPPROX YUNIT 2010-20YHIGHESTAPPROX ; but rose to YFIFTHAPPROX YUNIT from 2015-201YTHIRDAPPROX .
PLOTTITLE BARNAMES YLABEL YLEAST YUNIT XLEAST YSECOND YUNIT XSECOND YHIGHESTAPPROX YUNIT XHIGHEST	This graph shows a PLOTTITLE in BARNAMES . the YLABEL is YLEAST YUNIT in XLEAST , YSECOND YUNIT in XSECOND and just over YHIGHESTAPPROX YUNIT in the XHIGHEST .
YLABEL PLOTTITLE YHIGHEST YUNIT XHIGHEST YSECOND YUNIT XSECOND YSECOND YUNIT XSECOND YLEAST YUNIT XLEAST	This chart shows the YLABEL of PLOTTITLE . YHIGHEST YUNIT choose a XHIGHEST ; YSECOND YUNIT choose XSECOND , YSECOND YUNIT choose XSECOND and only YLEAST YUNIT choose XLEAST .
YLABEL T1AB XHIGHEST YHIGHESTAPPROX YUNIT XLEAST YLEASTAPPROX YUNIT XFIFTH	The YLABEL in the T1AB has seen a decrease over time . It started up high XHIGHEST at YHIGHESTAPPROX YUNIT and casually dropped to its lowest point XLEAST at YLEASTAPPROX YUNIT where it began to rise again XFIFTH .
YLABEL YMAG YUNIT PLOTTITLE COUNT XLABEL XHIGHEST YLABEL YUNIT YHIGHESTAPPROX YMAG XLEAST YUNIT YLEASTAPPROX YMAG MULLEASTHIGHEST YUNIT XSECOND YUNIT YSECONDAPPROX YMAG XTHIRD YUNIT YTHIRDAPPROX YMAG	The chart shows the YLABEL ( in YMAG , YUNIT ) of PLOTTITLE on COUNT different XLABEL . XHIGHEST spends the highest YLABEL at YUNIT YHIGHESTAPPROX YMAG and XLEAST spends the least at YUNIT YLEASTAPPROX YMAG - a difference of MULLEASTHIGHEST YUNIT . XSECOND spends YUNIT YSECONDAPPROX YMAG and XTHIRD spends YUNIT YTHIRDAPPROX YMAG .
PLOTTITLE COUNT T0AX XLABEL YLABEL XLEAST YLEAST YUNIT XSECOND YSECOND YUNIT XHIGHEST YLABEL YHIGHEST YUNIT	this chart shows the PLOTTITLE across COUNT T0AX XLABEL , the lowest YLABEL being XLEAST with YLEAST YUNIT , XSECOND with YSECOND YUNIT and the XHIGHEST having the biggest YLABEL with 1YLEAST YUNIT
COUNT XLABEL T1AB XLABEL XHIGHEST YHIGHESTAPPROX YUNIT XLABEL YLEASTAPPROX YUNIT XLEAST	This chart indicates COUNT possible XLABEL in the T1AB . It indicates the main XLABEL was attributed to XHIGHEST with YHIGHESTAPPROX YUNIT of the sample identifying that as the main XLABEL . Only YLEASTAPPROX YUNIT indicated XLEAST contributed to the problem .
PLOTTITLE XLABEL YLABEL XHIGHEST YUNIT YHIGHESTAPPROX YMAG YLABEL XSECOND YUNIT YSECONDAPPROX YMAG YLABEL T1AY T1AB XTHIRD YUNIT YTHIRD YMAG YLABEL XLEAST YUNIT YLEASTAPPROX YMAG	This graph shows the PLOTTITLE on XLABEL . The most YLABEL was in XHIGHEST where YUNIT YHIGHESTAPPROX YMAG was spent . The YLABEL in XSECOND was a little lower at YUNIT YSECONDAPPROX YMAG . The YLABEL of YLABEL on T1AY in T1AB in XTHIRD was YUNIT YTHIRD YMAG and the lowest YLABEL was spent in XLEAST , which was a little under YUNIT YLEASTAPPROX YMAG .
BARNAMES YLABEL XLABEL YLABEL XHIGHEST YHIGHEST YUNIT XSECOND YSECONDAPPROX YUNIT XLEAST ADDLEASTSECOND YLEASTAPPROX YUNIT	This graph demonstrates the differences between BARNAMES in terms of the YLABEL in each of those XLABEL . \\n The YLABEL was the largest in XHIGHEST at YHIGHEST YUNIT with the XSECOND very close behind at between 20-YHIGHEST YUNIT . \\n XLEAST is ADDLEASTSECOND YUNIT lower than this at 1ADDLEASTSECOND YUNIT
PLOTTITLE XHIGHEST YHIGHEST YUNIT MULSECONDHIGHEST YUNIT XSECOND MULTHIRDSECOND YUNIT XTHIRD XFOURTH YLABEL ADDFOURTHTHIRD XLEAST MULLEASTFOURTH YUNIT YLABEL INTERVAL XSTART XHIGHEST XEND XLEAST MULLEASTHIGHEST YUNIT	The chart shows the PLOTTITLE . In XHIGHEST there was YHIGHEST YUNIT . This decreased by MULSECONDHIGHEST YUNIT by XSECOND and then there was a massive drop of MULTHIRDSECOND YUNIT in XTHIRD . In XFOURTH the YLABEL decreased by ADDFOURTHTHIRD and then in MULLEASTFOURTHADDFOURTHTHIRD6 there was a further MULLEASTFOURTH YUNIT drop . \\n It is clear XSTART the chart the YLABEL have decreased INTERVAL and XSTART XHIGHEST XEND MULLEASTFOURTHADDFOURTHTHIRD6 there was a MULLEASTHIGHEST YUNIT decrease .
PLOTTITLE XHIGHEST YLABEL YHIGHESTAPPROX YUNIT XLEAST GRFIFTHLEAST YLABEL ADDFIFTHLEAST YUNIT	The charts show the PLOTTITLE . XHIGHEST had the highest YLABEL at YHIGHESTAPPROX YUNIT but there was a steady decrease until XLEAST . From 2010-XLEAST to 2015-2019 there was an increase in YLABEL by ADDFIFTHLEAST YUNIT
PLOTTITLE XHIGHEST YLABEL T1AY T1AY YHIGHESTAPPROX YUNIT T1AY YLABEL XLEAST YLEASTAPPROX YUNIT T1AY T1AY	this chart demonstrates the PLOTTITLE . findings show that the XHIGHEST spend the most YLABEL on T1AY , T1AY YHIGHESTAPPROX YUNIT a T1AY . as the age range increases the YLABEL spent decreases , XLEAST only spending YLEASTAPPROX YUNIT per T1AY on T1AY
YLABEL T1AY COUNT XLABEL T1AB XHIGHEST YUNIT YHIGHESTAPPROX YMAG XSECOND YUNIT YSECONDAPPROX YMAG XTHIRD YUNIT YTHIRDAPPROX YMAG T1AB XLEAST YUNIT YLEASTAPPROX YMAG	This chart shows how much YLABEL was spent on T1AY by each of the COUNT XLABEL in the T1AB . \\n XHIGHEST spent the most at around YUNIT YHIGHESTAPPROX YMAG . XSECOND comes second in line with spending YUNIT YSECONDAPPROX YMAG . XTHIRD spent about YUNIT YTHIRDAPPROX YMAG in T1AB . XLEAST spent the least with just under YUNIT YLEASTAPPROX YMAG .
PLOTTITLE YLEAST YUNIT T1AX XLEAST XLABEL YTHIRDAPPROX YUNIT XTHIRD GRYHIGHESTSECOND YUNIT GRHIGHESTSECOND T1AX XHIGHEST	This chart shows PLOTTITLE . YLEAST YUNIT T1AX a XLEAST XLABEL , rising to almost YTHIRDAPPROX YUNIT studying XTHIRD , then around GRYHIGHESTSECOND YUNIT for both GRHIGHESTSECOND with slightly more T1AX XHIGHEST .
YLABEL XLABEL XHIGHEST YLABEL YHIGHEST YUNIT XLEAST YLEAST YUNIT ADDHIGHESTLEAST YUNIT XTHIRD XEND YTHIRD YUNIT	The charts show the YLABEL in XLABEL . XHIGHEST has the highest YLABEL at YHIGHEST YUNIT whereas XLEAST has the lowest at YLEAST YUNIT - a ADDHIGHESTLEAST YUNIT difference . XTHIRD appear XEND have the most equal representation with YTHIRD YUNIT .
PLOTTITLE XTHIRD XEND XHIGHEST YUNIT YTHIRDAPPROX XTHIRD YUNIT YHIGHESTAPPROX XHIGHEST YUNIT YFOURTHAPPROX XFOURTH YUNIT YLEASTAPPROX XLEAST	This graph shows the PLOTTITLE . They steadily climb XTHIRD XEND XHIGHEST from just over YUNIT YTHIRDAPPROX on XTHIRDday peaking at YUNIT YHIGHESTAPPROX on XHIGHESTnesday . They then plummet XEND YUNIT YFOURTHAPPROX on XFOURTH and fall again XEND just under YUNIT YLEASTAPPROX on XLEAST .
PLOTTITLE XHIGHEST YLABEL T1AY YLABEL T0AY XLEAST YUNIT ADDLEASTHIGHEST YMAG XHIGHEST	This chart represents the PLOTTITLE . \\n \\n Whilst there was an increase in XHIGHEST , since then the YLABEL is showing a downward trend , with the T1AY YLABEL T0AY in XLEAST being YUNIT ADDLEASTHIGHEST YMAG less than in XHIGHEST .
YLABEL T1AB XHIGHEST YLABEL YUNIT YHIGHESTAPPROX YUNIT YLEASTAPPROX XLEAST	This chart shows the steep decline in YLABEL for T1AB during the course of the week . Opening on XHIGHEST , the YLABEL is at its peak of YUNIT YHIGHESTAPPROX , before dropping gradually over the week to an eventual low of YUNIT YLEASTAPPROX on the XLEAST .
PLOTTITLE XHIGHEST YUNIT YHIGHESTAPPROX XSECOND YUNIT YSECONDAPPROX XTHIRD YUNIT YTHIRDAPPROX XFOURTH YUNIT YFOURTHAPPROX XLEAST YUNIT YLEASTAPPROX	This chart shows PLOTTITLE . The highest is XHIGHEST at YUNIT YHIGHESTAPPROX then XSECOND at YUNIT YSECONDAPPROX , then XTHIRD at YUNIT YTHIRDAPPROX then XFOURTH at YUNIT YFOURTHAPPROX and lastly XLEAST at YUNIT YLEASTAPPROX .
PLOTTITLE BARNAMES T0AY YLABEL T1AB	This charts shows the PLOTTITLE in BARNAMES . The chart shows a trend of increasing T0AY YLABEL of T1AB . However it doesn't show how this relates to inflation .
PLOTTITLE YUNIT YHIGHESTAPPROX XHIGHEST YUNIT YLEASTAPPROX XLEAST GRTHIRDFOURTH GRYTHIRDFOURTH YUNIT YUNIT YLEASTAPPROX XLEAST	This PLOTTITLE is shown in this graph . There has been a steady decline over the week from over YUNIT YHIGHESTAPPROX on XHIGHEST to around YUNIT YLEASTAPPROX on XLEAST . Things were looking more promising GRTHIRDFOURTH where the decrease levelled off at GRYTHIRDFOURTH YUNIT however a further decrease to YUNIT YLEASTAPPROX occurred by the close of XLEAST .
YLABEL PLOTTITLE T1AY XHIGHEST YHIGHEST YUNIT YSECOND YUNIT T1AY XSECOND YLEASTAPPROX YUNIT XTHIRD YLEAST YUNIT XLEAST	The chart shows the YLABEL of PLOTTITLE . It shows us that they are most T1AY within XHIGHEST , at YHIGHEST YUNIT . They are YSECOND YUNIT T1AY within XSECOND , just less than YLEASTAPPROX YUNIT in XTHIRD and only YLEAST YUNIT in XLEAST .
YHIGHEST YUNIT T1AY T1AY XHIGHEST GRYSECONDTHIRD YUNIT T1AY GRSECONDTHIRD YLEAST YUNIT T1AX T1AY XLEAST	YHIGHEST YUNIT of T1AY choose to T1AY XHIGHEST , GRYSECONDTHIRD YUNIT each choose to T1AY GRSECONDTHIRD , with only YLEAST YUNIT T1AX to T1AY XLEAST .
PLOTTITLE COUNT XLABEL XLABEL XHIGHEST YHIGHEST YUNIT XLABEL XSECOND YSECOND YUNIT XLEAST YLEAST YUNIT	The chart represents what PLOTTITLE are and the bar chart shows the following COUNT XLABEL . The largest XLABEL is due to the XHIGHEST . This contributes to YHIGHEST YUNIT of the XLABEL . This is followed by XSECOND at COUNT0 YUNIT and finally a XLEAST at YLEAST YUNIT .
T1AB XHIGHEST BARSREST YLABEL XLEAST XTHIRD XLABEL XSECOND XLABEL YLABEL T1AB T1AY	This shows that T1AB with XHIGHEST earn more than their BARSREST . The lowest YLABEL are to those who have XLEAST , followed by a XTHIRD XLABEL then a XSECOND XLABEL - therefore we can take from this graph that the higher the level of education , the higher the YLABEL T1AB earn T1AY
PLOTTITLE YLABEL T1AB XHIGHEST YUNIT YHIGHESTAPPROX YLABEL XLEAST YUNIT YLEASTAPPROX XTHIRD XSECOND XHIGHEST XFOURTH XLEAST	This chart represents the PLOTTITLE . \\n \\n The highest YLABEL for T1AB is on XHIGHEST at YUNIT YHIGHESTAPPROX , the lowest YLABEL of the week is XLEAST at YUNIT YLEASTAPPROX which is a huge difference . \\n \\n The market appears to start off slowly on a XTHIRD and gradually increases on XSECOND . It peaks on a XHIGHEST , it drops significantly on XFOURTH and a low on a XLEAST .
YLABEL XLABEL T1AB T1AB YLABEL XHIGHEST YUNIT YHIGHESTAPPROX YMAG YUNIT YSECONDAPPROX YMAG XLABEL XSECOND XHIGHEST YUNIT YTHIRDAPPROX YMAG XLABEL XTHIRD YUNIT YLEAST YMAG XLEAST	The YLABEL per XLABEL of T1AB in T1AB has been changing with the XLABELs , the highest YLABEL was on XHIGHEST , being this YUNIT YHIGHESTAPPROX YMAG , which was good sign of growing since it was around YUNIT YSECONDAPPROX YMAG in the XLABEL 2YMAG . Unfortunately instead of growing after XHIGHEST , it actually decreased to nearly YUNIT YTHIRDAPPROX YMAG by the XLABEL XTHIRD and it continued decreasing to YUNIT YLEAST YMAG for the XLABEL XLEAST . If this trend is to continue there were be a decrease in the following XLABELs .
XLABEL XHIGHEST YHIGHEST YUNIT XSECOND YSECOND YUNIT XLEAST YLEAST YUNIT	The table shows that the leading XLABEL is XHIGHEST ( YHIGHEST YUNIT ) , followed by XSECOND ( YSECOND YUNIT ) and finally XLEAST ( YLEAST YUNIT ) .
PLOTTITLE YLABEL T1AY T1AY XLABEL XHIGHEST YLABEL T1AY T1AY T1AB XLABEL XLEAST	This chart shows the PLOTTITLE . \\n From the chart we see that the highest YLABEL spent T1AY on T1AY is from the XLABEL of XHIGHEST . We can see that there is a gradual decline of the YLABEL spent T1AY on T1AY in T1AB spent T1AY on T1AY in T1AB with the increase in age , with the lowest XLABEL being XLEAST
YLABEL YMAG YUNIT T1AY T1AB COUNT XLABEL XHIGHEST XSECOND XTHIRD XLEAST	The graph demonstrates the YLABEL in YMAG of YUNIT spent on T1AY in T1AB in COUNT different XLABEL . \\n \\n XHIGHEST was the highest , then followed by XSECOND , then XTHIRD and finally XLEAST was the lowest .
YLABEL T1AB XSTART XSECOND XEND XFOURTH YMEAN XHIGHEST YHIGHEST XLEAST YLEAST	YLABEL at the T1AB have varied XSTART XSECOND XEND XFOURTH , averaging above YMEAN . Most was in XHIGHEST at YHIGHEST , and least in XLEAST at YLEAST .
PLOTTITLE XSTART XHIGHEST XEND XFIFTH YHIGHESTAPPROX YUNIT XHIGHEST XSECOND YSECOND YUNIT YTHIRDAPPROX YUNIT XTHIRD YFOURTHAPPROX YUNIT XFOURTH YLEASTAPPROX YUNIT XLEAST XFIFTH YFIFTH YUNIT	This chart shows the PLOTTITLE XSTART XHIGHEST XEND XFIFTH . The highest is YHIGHESTAPPROX YUNIT in XHIGHESTXEND94 , followed by 95XEND99 at YSECOND YUNIT then just over YTHIRDAPPROX YUNIT in 2000XEND2004 , YTHIRDAPPROX YUNIT in 2005XEND2009 , a drop to YLEASTAPPROX YUNIT in 2010XEND20YHIGHESTAPPROX then up again in 2015XENDXFIFTH to about YFIFTH YUNIT .
PLOTTITLE XHIGHEST YLABEL YHIGHEST YUNIT XSECOND ADDSECONDHIGHEST YUNIT YSECOND YUNIT XLEAST YLABEL YLEASTAPPROX YUNIT	This chart represents the PLOTTITLE . XHIGHEST YLABEL is YHIGHEST YUNIT , whilst the XSECOND settles ADDSECONDHIGHEST YUNIT below at YSECOND YUNIT . Overall XLEAST is seen to have the lowest YLABEL at ADDSECONDHIGHEST5 YUNIT .
PLOTTITLE YHIGHEST YUNIT T1AY XHIGHEST XSECOND T1AY YSECOND YUNIT YTHIRD YUNIT T1AY XTHIRD YLEAST YUNIT XLEAST T1AY	This chart shows the PLOTTITLE . \\n \\n YHIGHEST YUNIT of T1AY study XHIGHEST , closely followed by XSECOND T1AY at YSECOND YUNIT . \\n YTHIRD YUNIT of T1AY study XTHIRD , and YLEAST YUNIT are XLEAST T1AY .
PLOTTITLE XLABEL T1AX YHIGHEST YUNIT XHIGHEST YSECOND YUNIT XSECOND YLEAST YUNIT XLEAST	This graph shows PLOTTITLE or is a XLABEL in T1AX . YHIGHEST YUNIT XHIGHEST \\n YSECOND YUNIT XSECOND \\n YLEAST YUNIT XLEAST
PLOTTITLE XLABEL YUNIT YSECOND YMAG XSECOND YUNIT YTHIRD YMAG XTHIRD YUNIT YHIGHEST YMAG XHIGHEST YUNIT YLEAST YMAG XLEAST	This shows the PLOTTITLE by different XLABEL , despite the title at the bottom saying countries . \\n \\n YUNIT YSECOND YMAG - XSECOND \\n YUNIT YTHIRD YMAG - XTHIRD \\n YUNIT YHIGHEST YMAG - XHIGHEST \\n YUNIT YLEAST YMAG - XLEAST
PLOTTITLE YLEAST YUNIT T1AY XLEAST YSECOND YUNIT XSECOND YHIGHESTAPPROX YUNIT T0AY XHIGHEST YTHIRDAPPROX YUNIT YLABEL XTHIRD	This chart shows PLOTTITLE . Approximately YLEAST YUNIT of T1AY XLEAST , YSECOND YUNIT XSECOND and YHIGHESTAPPROX YUNIT of T0AY XHIGHEST . About YTHIRDAPPROX YUNIT of T1AY surveyed XTHIRD .
PLOTTITLE XHIGHEST YLABEL YHIGHEST YUNIT XLEAST YLEAST YUNIT T1AY	This chart displays information of PLOTTITLE . XHIGHEST have the highest YLABEL with YHIGHEST YUNIT and XLEAST has the lowest with YLEAST YUNIT of T1AY .
PLOTTITLE YLABEL XHIGHEST XHIGHEST XLEAST YLABEL	The chart shows the PLOTTITLE . The YLABEL is highest XHIGHEST on XHIGHEST and XLEAST is where the YLABEL is the lowest .
PLOTTITLE T1AY YHIGHEST YUNIT XHIGHEST XSECOND YSECOND YUNIT XTHIRD YTHIRD YUNIT XLEAST YLEAST YUNIT	this graph shows PLOTTITLE , most T1AY ( YHIGHEST YUNIT ) choose XHIGHEST , followed by XSECOND ( YSECOND YUNIT ) , XTHIRD ( YTHIRD YUNIT ) or XLEAST ( YLEAST YUNIT ) . XLEAST may be the least poplar as it is considered a older hobby and a more feminine hobby .
YLABEL T1AB XSTART XLABEL XLEAST XEND XHIGHEST XLEAST YLEASTAPPROX YUNIT XHIGHEST YHIGHEST YUNIT	YLABEL in the T1AB has steadily increased XSTART the XLABEL XLEAST XEND XHIGHEST . XSTART XLEAST XEND 1994 it was approximately YLEASTAPPROX YUNIT XEND in the XLABEL 2015 XEND XHIGHEST it was approximately YHIGHEST YUNIT .
PLOTTITLE INTERVAL XLABEL INTERVAL XLABEL YLABEL YLEAST YUNIT XEND YHIGHESTAPPROX YUNIT XHIGHEST XLEAST XFIFTH YLABEL YLEAST YUNIT YFIFTHAPPROX YUNIT MULSECONDLEAST XFIFTH XFOURTH YFIFTHAPPROX YUNIT YFOURTH YUNIT GRHIGHESTSECONDTHIRD SLOPEX SLOPEY YUNIT ADDHIGHESTSECOND YUNIT XHIGHEST YLABEL	This graph shows the PLOTTITLE over the last INTERVAL XLABEL . \\n Over the period of INTERVAL XLABEL YLABEL has increased from YLEAST YUNIT up XEND YHIGHESTAPPROX YUNIT in XHIGHEST . \\n XLEAST XEND the XFIFTH the YLABEL increased from YLEAST YUNIT XEND just over YFIFTHAPPROX YUNIT , more than than MULSECONDLEAST . \\n The biggest increase was seen XFIFTH and the YFIFTHAPPROX000-YFIFTHAPPROX004 terms , from YFIFTHAPPROX YUNIT up XEND YFOURTH YUNIT . GRHIGHESTSECONDTHIRD a steady increase has been seen SLOPEX of around YFIFTHAPPROX.5 YUNIT , with a slowing down of this XEND ADDHIGHESTSECOND YUNIT in the XHIGHEST of YLABEL .
PLOTTITLE XLABEL YLABEL XHIGHEST YHIGHESTAPPROX YUNIT XLEAST YLEASTAPPROX YUNIT XSECOND YLABEL YSECOND YUNIT XTHIRD YTHIRD YUNIT	The PLOTTITLE varies according to the XLABEL . The highest YLABEL can be found in the XHIGHEST with a YHIGHESTAPPROX YUNIT , while the lowest is in Law Firms XLABEL with around YLEASTAPPROX YUNIT . \\n The tech XLABEL has a YLABEL of around YSECOND YUNIT , while the XTHIRD YTHIRD YUNIT .
PLOTTITLE XLABEL XHIGHEST YLABEL YHIGHESTAPPROX YUNIT XLABEL XSECOND YLABEL YSECONDAPPROX YUNIT XTHIRD XLABEL YTHIRDAPPROX YUNIT XFOURTH YLABEL YFOURTHAPPROX YUNIT XLABEL XLEAST YLABEL T1AY YLEASTAPPROX YUNIT T1AY	This chart shows the PLOTTITLE . \\n The XLABEL XHIGHEST shows the most YLABEL spent at about YHIGHESTAPPROX YUNIT . The second XLABEL of XSECOND shows a slightly lesser YLABEL of approximately YSECONDAPPROX YUNIT . People in the XTHIRD XLABEL spend about YTHIRDAPPROX YUNIT . Those that are XFOURTH spend even less YLABEL which is just under YFOURTHAPPROX YUNIT . However the XLABEL of XLEAST show the lowest YLABEL of YLABEL spent with the T1AY of about YLEASTAPPROX YUNIT a T1AY .
PLOTTITLE XSECOND YSECONDAPPROX YUNIT T1AY XFOURTH YFOURTHAPPROX YUNIT XLEAST YLEASTAPPROX YUNIT XHIGHEST YHIGHESTAPPROX YUNIT XTHIRD YTHIRDAPPROX YUNIT XLABEL XHIGHEST YLABEL T1AY	This chart conveys the PLOTTITLE . XSECOND spend YSECONDAPPROX YUNIT on T1AY , XFOURTH spend YFOURTHAPPROX YUNIT , XLEAST spend YLEASTAPPROX YUNIT , XHIGHEST spend YHIGHESTAPPROX YUNIT and XTHIRD spend YTHIRDAPPROX YUNIT . \\n XLABEL XHIGHEST spend the most YLABEL on T1AY .
PLOTTITLE YTHIRD XTHIRD YLABEL XSECOND XHIGHEST T1AY XLEAST	This chart represents the PLOTTITLE . \\n \\n There is YTHIRD in XTHIRD , with a higher YLABEL in XSECOND and XHIGHEST . \\n \\n T1AY appear to be under represented in the XLEAST .
PLOTTITLE XHIGHEST YHIGHEST YUNIT GRSECONDTHIRD GRYSECONDTHIRD YUNIT XLEAST YLEAST YUNIT	this graph shows PLOTTITLE , most popular is XHIGHEST with YHIGHEST YUNIT , followed by GRSECONDTHIRD with GRYSECONDTHIRD YUNIT and XLEAST with YLEAST YUNIT . this may be reflective of students opting to choose to study fields with future job prospects
YLABEL T1AB XSTART XLEAST XEND XHIGHEST YLABEL YLEAST YUNIT XLEAST YHIGHEST YUNIT XHIGHEST	This chart shows that there has been an increase in the YLABEL in the T1AB XSTART XLEAST XEND XHIGHEST . \\n \\n YLABEL has increased XSTART < YLEAST YUNIT in XLEAST-1994 XEND YHIGHEST YUNIT in YLEAST015-XHIGHEST .
PLOTTITLE GRHIGHESTSECOND XLABEL GRYHIGHESTSECOND YUNIT XLEAST YLEAST YUNIT	this chart shows PLOTTITLE . GRHIGHESTSECOND are the most popular XLABEL at around GRYHIGHESTSECOND YUNIT , XLEAST the least popular at YLEAST YUNIT .
XHIGHEST YLABEL XLABEL YHIGHEST YUNIT XLEAST YLEAST YUNIT XSECOND YSECOND YUNIT XTHIRD XFOURTH YTHIRD YFOURTH YUNIT	XHIGHEST has the highest YLABEL in XLABEL with YHIGHEST YUNIT however XLEAST has only YLEAST YUNIT , a rather large difference . XSECOND follows closely behind with YSECOND YUNIT but XTHIRD and XFOURTH are even lower again at YTHIRD and YFOURTH YUNIT .
PLOTTITLE T1AY T1AX XHIGHEST YHIGHEST YUNIT XLABEL XSECOND YSECOND YUNIT XTHIRD YTHIRD YUNIT YLEAST YUNIT T1AY XLEAST T1AX	This graph shows the PLOTTITLE . Most T1AY spend their T1AX XHIGHEST this accounts for YHIGHEST YUNIT . The next XLABEL is XSECOND with YSECOND YUNIT , then XTHIRD at YTHIRD YUNIT and lastly only YLEAST YUNIT of T1AY XLEAST in the T1AX . The lack of book reading is probably due to more technology being ready accessible
PLOTTITLE XSTART XHIGHEST XEND XFIFTH XHIGHEST INTERVAL XLABEL XFIFTH XFIFTH YLABEL	This bar chart is a PLOTTITLE XSTART XHIGHEST XEND XFIFTH . \\n In XHIGHEST it was at its highest peak , which every INTERVAL XLABEL it deteriorated until 201INTERVAL . From 201INTERVALXENDXFIFTH for the first time it rose again gaining a higher YLABEL .
XHIGHEST YLABEL MULHIGHESTLEAST XLEAST	The XHIGHEST has the highest YLABEL which is more than MULHIGHESTLEAST the lowest of XLEAST
XLABEL T1AB XHIGHEST YHIGHESTAPPROX YUNIT XSECOND YSECONDAPPROX YUNIT XLEAST YLEASTAPPROX YUNIT	The biggest XLABEL in T1AB is XHIGHEST , accounting for YHIGHESTAPPROX YUNIT . XSECOND is YSECONDAPPROX YUNIT and XLEAST YLEASTAPPROX YUNIT .
XHIGHEST YLABEL T1AY XSECOND	XHIGHEST has the highest YLABEL of T1AY followed by XSECOND
YLABEL XHIGHEST YHIGHEST YUNIT YTHIRD YUNIT XTHIRD YSECOND YUNIT YLABEL XSECOND GRYFOURTHLEAST YUNIT GRFOURTHLEAST	this graph shows that the YLABEL entering XHIGHEST is at almost YHIGHEST YUNIT compared to only YTHIRD YUNIT entering XTHIRD . Almost YSECOND YUNIT of YLABEL in XSECOND compared to less than GRYFOURTHLEAST YUNIT in both GRFOURTHLEAST .
YLABEL T1AY XHIGHEST YHIGHEST YUNIT YSECOND YUNIT XSECOND T1AX YTHIRD YUNIT XTHIRD MULTHIRDHIGHEST XHIGHEST YLEAST YUNIT XLEAST	A high YLABEL of T1AY XHIGHEST ( YHIGHEST YUNIT ) ; this figure presumably applies to pre-internet days . YSECOND YUNIT XSECOND for the T1AX . YTHIRD YUNIT XTHIRD , exactly MULTHIRDHIGHEST of those XHIGHEST , so they are not XHIGHEST with their families in this case . YLEAST YUNIT XLEAST .
XHIGHEST YHIGHEST YUNIT T1AY XSECOND YSECOND YUNIT XLEAST YLEAST YUNIT	XHIGHEST causes YHIGHEST YUNIT of T1AY , XSECOND some YSECOND YUNIT whilst XLEAST contributes the other YLEAST YUNIT
PLOTTITLE YHIGHEST YUNIT T1AY XHIGHEST YSECOND YUNIT XSECOND YLEAST YUNIT XLEAST	This graphs illustrates the PLOTTITLE . YHIGHEST YUNIT of T1AY is caused by XHIGHEST , YSECOND YUNIT by XSECOND and YLEAST YUNIT by XLEAST .
YLABEL T1AB XHIGHEST YHIGHEST YUNIT MULFOURTHFIFTH XFIFTH YFIFTHAPPROX YUNIT YFOURTHAPPROX YUNIT XFOURTH XFOURTH SLOPEY YUNIT YLEASTAPPROX YUNIT XLEAST YHIGHEST YUNIT XHIGHEST	YLABEL in the TYLEASTAPPROXAB is highest in XHIGHEST at over YHIGHEST YUNIT . It more than MULFOURTHFIFTH from XFIFTH from YFIFTHAPPROX YUNIT to YFOURTHAPPROX YUNIT in YFIFTHAPPROX000-YFIFTHAPPROX004 . \\n Year on year from YFIFTHAPPROX000 it has increased on average SLOPEY YUNIT from less than YLEASTAPPROX YUNIT in YLEASTAPPROX990 to YHIGHEST YUNIT in XHIGHEST
PLOTTITLE XHIGHEST YHIGHESTAPPROX YMAG XSECOND YSECONDAPPROX YMAG XTHIRD YTHIRDAPPROX YMAG XLEAST YLEASTAPPROX YMAG YLABEL	this chart shows PLOTTITLE , those with a XHIGHEST look to earn over YHIGHESTAPPROX YMAG , followed by XSECOND with YSECONDAPPROX YMAG \\n XTHIRD with over YTHIRDAPPROX YMAG and XLEAST YLEASTAPPROX YMAG . showing that evidence indicates that the higher education you have completed the higher your YLABEL will be
YLABEL T1AY T1AB XLABEL XLABEL XHIGHEST YLABEL YHIGHESTAPPROX YMAG YUNIT XSECOND YLABEL YSECONDAPPROX YMAG YUNIT GRTHIRDLEAST GRYTHIRDLEAST YMAG XTHIRD GRTHIRDLEAST YTHIRDAPPROX YMAG YUNIT XLEAST YLEASTAPPROX YMAG YUNIT	The YLABEL on T1AY on the T1AB vary by XLABEL . \\n The XLABEL that spent the most was XHIGHEST with an YLABEL of around YHIGHESTAPPROX YMAG of YUNIT , followed by XSECOND with an YLABEL of around YSECONDAPPROX YMAG of YUNIT . GRTHIRDLEAST spent less than GRYTHIRDLEAST YMAG , XTHIRD was the bigger of GRTHIRDLEAST with around YTHIRDAPPROX YMAG of YUNIT , while XLEAST spent close to the YLEASTAPPROX YMAG of YUNIT .
XHIGHEST YLABEL T1AY T1AY YHIGHESTAPPROX YUNIT T1AY XSECOND YSECONDAPPROX YUNIT T1AY T1AY T1AY XTHIRD YTHIRDAPPROX YUNIT T1AY YLABEL T1AY T1AY T1AY XFOURTH YFOURTHAPPROX YUNIT XLEAST YLEASTAPPROX YUNIT	XHIGHEST spent the most YLABEL on T1AY on a T1AY basis , at YHIGHESTAPPROX YUNIT . On T1AY , XSECOND spent YSECONDAPPROX YUNIT T1AY on T1AY . On T1AY XTHIRD spent YTHIRDAPPROX YUNIT on T1AY . The lowest YLABEL spent on T1AY on T1AY on a T1AY basis were XFOURTH at YFOURTHAPPROX YUNIT and XLEAST at YLEASTAPPROX YUNIT .
PLOTTITLE YLABEL XHIGHEST XSECOND YLABEL XTHIRD XLEAST	This chart shows PLOTTITLE . We can see that a high YLABEL XHIGHEST or XSECOND whilst a much smaller YLABEL XTHIRD or XLEAST .
PLOTTITLE XLABEL XHIGHEST YHIGHESTAPPROX YUNIT XSECOND YSECONDAPPROX YUNIT XLEAST YLEASTAPPROX YUNIT	PLOTTITLE . Main XLABEL is XHIGHEST at YHIGHESTAPPROX YUNIT . Then XSECOND at YSECONDAPPROX YUNIT , finally XLEAST at YLEASTAPPROX YUNIT .
XHIGHEST T1AY YUNIT YHIGHESTAPPROX YMAG XSECOND YUNIT YSECOND YMAG XTHIRD YUNIT YTHIRD YMAG XLEAST YUNIT YLEAST YMAG	The chart shows that XHIGHEST spends the most on T1AY , spending over YUNIT YHIGHESTAPPROX YMAG , XSECOND is 2nd , spending YUNIT YSECOND YMAG . XTHIRD is 3rd , spending YUNIT YTHIRD YMAG , and XLEAST 4th , spending YUNIT YLEAST YMAG .
PLOTTITLE COUNT XLABEL BARNAMES XHIGHEST YSECOND YUNIT T1AY T1AX XSECOND YSECOND YUNIT T1AB XLEAST YLEAST YUNIT T1AB	As you can see this graph shows the PLOTTITLE COUNT different XLABEL these being , BARNAMES . XHIGHEST was the most popular with just over YSECOND YUNIT of T1AY T1AX it although XSECOND was close with YSECOND YUNIT T1AX it . The least popular was XLEAST with only YLEAST YUNIT T1AX it .
PLOTTITLE XLABEL YLABEL XHIGHEST YLABEL YUNIT YHIGHESTAPPROX XSECOND YLABEL YUNIT YSECONDAPPROX XTHIRD XLABEL YLABEL YUNIT YFOURTHAPPROX GRFOURTHLEAST GRHIGHESTSECONDTHIRD YLABEL YUNIT YTHIRDAPPROX YUNIT YFOURTHAPPROX XFOURTH YUNIT YLEASTAPPROX XLEAST	This chart is about the PLOTTITLE The XLABEL with the highest YLABEL was WednesXLABEL , with a YLABEL of about YUNIT YHIGHESTAPPROX . This was followed by TuesXLABEL with a YLABEL of YUNIT YSECONDAPPROX . MonXLABEL was also not a bad XLABEL , as the YLABEL was YUNIT YFOURTHAPPROX . Unfortunately ThursXLABEL and FriXLABEL did not do as well as the others XLABELs , as the YLABEL was below YUNIT YTHIRDAPPROX , YUNIT YFOURTHAPPROX for ThursXLABEL and YUNIT YLEASTAPPROX for FriXLABEL .
XSTART XLEAST XEND XHIGHEST T1AY YLABEL T1AB YUNIT YLEAST YMAG XLEAST YUNIT YHIGHESTAPPROX YMAG XHIGHEST	This graph shows that XSTART XLEAST XEND XHIGHEST the T1AY YLABEL of T1AB rose consistently XSTART YUNIT YLEAST YMAG in XLEAST to over YUNIT YHIGHESTAPPROX YMAG in XHIGHEST
PLOTTITLE GRYSECONDTHIRD YUNIT GRSECONDTHIRD GRYHIGHESTLEAST YUNIT GRHIGHESTLEAST YSECOND YUNIT T0AY GRSECONDTHIRD XSECOND YTHIRD YUNIT XTHIRD T0AY GRHIGHESTLEAST YHIGHEST YUNIT XHIGHEST YLEAST YUNIT XLEAST	This chart shows PLOTTITLE . With GRYSECONDTHIRD YUNIT choosing to GRSECONDTHIRD and the other GRYSECONDTHIRD YUNIT choosing GRHIGHESTLEAST . This is broken down with YSECOND YUNIT of the T0AY who prefer to GRSECONDTHIRD like to XSECOND and the remaining YTHIRD YUNIT choosing to XTHIRD . \\n The T0AY who prefer opting for GRHIGHESTLEAST are split with YHIGHEST YUNIT preferring to XHIGHEST , while the remaining YLEAST YUNIT prefer to XLEAST .
PLOTTITLE XHIGHEST YLABEL XSECOND XTHIRD XLEAST XLEAST YLABEL XLABEL YLEAST YUNIT XHIGHEST YHIGHEST YUNIT	this graph shows PLOTTITLE for example XHIGHEST have more YLABEL than XSECOND , XTHIRD or XLEAST . XLEAST has a very low YLABEL in their XLABEL with on YLEAST YUNIT compared to XHIGHEST YHIGHEST YUNIT
YLABEL T1AB YLABEL INTERVAL XLABEL YLEASTAPPROX YUNIT XLEAST YHIGHEST YUNIT XHIGHEST	Bar chart showing the increase in YLABEL in the T1AB . \\n \\n YLABEL increases every INTERVAL XLABEL - just YLEASTAPPROX YUNIT in the period of 1990-199INTERVAL , increasing to 1INTERVAL YUNIT in XHIGHEST
YLABEL XLABEL XLABEL XHIGHEST XLEAST XLABEL	This bar chart displays YLABEL in different XLABEL . The modal XLABEL is XHIGHEST . It is unclear where other departments like History or Social Science fit . XLEAST is the smallest XLABEL - but this in unsurprising as it is one subject compared to the conglomeration of XHIGHEST subjects .
T1AY BARNAMES XHIGHEST BARSREST	This graphs compares T1AY spending between BARNAMES . XHIGHEST spent the most , followed by BARSREST .
YLABEL PLOTTITLE BARNAMES XHIGHEST YLABEL XLEAST	This chat looks at the YLABEL PLOTTITLE in BARNAMES . The XHIGHEST has the largest PLOTTITLE with XLEAST having the lowest .
YLABEL GRFOURTHLEAST T1AY T0AY XLABEL XHIGHEST	This chart shows T1AY in Narvik are well represented within XLABELs traditionally seen as male dominated . In contrast , only a small YLABEL within GRFOURTHLEAST are T1AY . THe most T0AY XLABEL is XHIGHEST
YLABEL COUNT XLABEL YLABEL XHIGHEST YHIGHEST YUNIT XSECOND YSECONDAPPROX YUNIT XLEAST YLEASTAPPROX YUNIT	This graph shows the YLABEL in COUNT different XLABEL . \\n The YLABEL was largest in XHIGHEST at YHIGHEST YUNIT , the XSECOND next at just over YSECONDAPPROX YUNIT and XLEAST the lowest at YLEASTAPPROX YUNIT .
YLABEL COUNT XLABEL YUNIT T1AB XHIGHEST YHIGHEST YUNIT YLABEL XSECOND YLABEL YSECONDAPPROX YUNIT YLABEL XLEAST YLEASTAPPROX YUNIT	The graph depicts the YLABEL in COUNT XLABEL displayed as a YUNIT , for the T1AB . In XHIGHEST , there was a YHIGHEST YUNIT YLABEL , similar to the XSECOND YLABEL which was just over YSECONDAPPROX YUNIT . The YLABEL was smallest in XLEAST , at YLEASTAPPROX YUNIT .
PLOTTITLE XLABEL YLEAST YUNIT T1AY T0AY XLEAST T1AX YSECONDAPPROX YUNIT XSECOND YHIGHEST YUNIT XHIGHEST YTHIRD YUNIT XTHIRD	This graph depicts PLOTTITLE from the XLABEL assigned to the research . YLEAST YUNIT of T1AY spent T0AY XLEAST in the T1AX ; YSECONDAPPROX YUNIT spent T0AY with family , YHIGHEST YUNIT XHIGHEST , and YTHIRD YUNIT XTHIRD .
XHIGHEST YLABEL YHIGHESTAPPROX YUNIT XSECOND YSECOND YUNIT XLEAST YLEAST YUNIT	the table shows that the XHIGHEST has the biggest YLABEL ( YHIGHESTAPPROX YUNIT ) , followed by XSECOND ( YSECOND YUNIT ) and XLEAST ( YLEAST YUNIT ) .
PLOTTITLE XLABEL XSECOND YUNIT YSECONDAPPROX YMAG YUNIT YHIGHESTAPPROX YMAG XHIGHEST YUNIT YTHIRDAPPROX YMAG YUNIT YLEAST YMAG XTHIRD XLEAST	This chart shows the PLOTTITLE . In the XLABEL XSECOND , this was around YUNIT YSECONDAPPROX YMAG . This then rose to just over YUNIT YHIGHESTAPPROX YMAG in XHIGHEST , before dropping to YUNIT YTHIRDAPPROX YMAG and YUNIT YLEAST YMAG in XTHIRD and XLEAST respectively .
PLOTTITLE XSTART XLABEL XLEAST XEND XHIGHEST XLABEL T1AY YLABEL YLEAST YMAG XLEAST YHIGHESTAPPROX YMAG XHIGHEST	This chart shows the PLOTTITLE XSTART the XLABEL XLEAST XEND XHIGHEST . Over the XLABEL the T1AY YLABEL has increased it was YLEAST YMAG in XLEAST and is now YHIGHESTAPPROX YMAG in XHIGHEST .
YLABEL XHIGHEST YLABEL YHIGHESTAPPROX XSECOND YLABEL YSECOND YUNIT XLEAST COUNT YLABEL YLEAST YUNIT	This chart shows that the biggest YLABEL is in the XHIGHEST with a YLABEL of over YHIGHESTAPPROX . XSECOND has a YLABEL of YSECOND YUNIT and XLEAST is the lowest of the COUNT with a YLABEL of YLEAST YUNIT
BARNAMES YLABEL XHIGHEST YHIGHEST YUNIT XSECOND XLEAST YLEASTAPPROX YUNIT	Between BARNAMES the YLABEL is biggest in XHIGHEST at YHIGHEST YUNIT , a little more than in the XSECOND . XLEAST is at YLEASTAPPROX YUNIT .
XLEAST YLABEL YLEAST YUNIT XSECOND MULSECONDLEAST YSECOND YUNIT XHIGHEST YLABEL YHIGHEST YUNIT	XLEAST has the lowest YLABEL of just YLEAST YUNIT . XSECOND is MULSECONDLEAST that at YSECOND YUNIT and the XHIGHEST is behind with the largest YLABEL of 1YLEAST YUNIT .
PLOTTITLE XLABEL XSECOND YLABEL YUNIT YSECONDAPPROX YMAG YUNIT YHIGHESTAPPROX YMAG XLABEL XHIGHEST XLABEL XTHIRD YUNIT YTHIRDAPPROX YMAG XLABEL XLEAST YUNIT YLEAST YMAG	This graph shows the PLOTTITLE . In the XLABEL XSECOND the YLABEL was YUNIT YSECONDAPPROX YMAG . This increased to YUNIT YHIGHESTAPPROX YMAG in the XLABEL XHIGHEST . There was a decrease by the XLABEL XTHIRD to slightly under YUNIT YTHIRDAPPROX YMAG and another decrease by the XLABEL YTHIRDAPPROX15 to around YUNIT YLEAST YMAG .
YLABEL GRHIGHESTSECONDTHIRD YUNIT YTHIRDAPPROX YUNIT YHIGHESTAPPROX GRFOURTHLEAST YUNIT YHIGHESTAPPROX XHIGHEST YUNIT YFOURTHAPPROX XFOURTH YUNIT YLEASTAPPROX XLEAST	This chart shows that the YLABEL increase GRHIGHESTSECONDTHIRD ( from YUNIT YTHIRDAPPROX to YUNIT YHIGHESTAPPROX ) , but drop on GRFOURTHLEAST . From YUNIT YHIGHESTAPPROX on XHIGHEST to roughly YUNIT YFOURTHAPPROX on XFOURTH , then around YUNIT YLEASTAPPROX on XLEAST .
PLOTTITLE XSTART XSECOND XEND XLEAST YLABEL XHIGHEST YUNIT YHIGHESTAPPROX YMAG XHIGHEST YUNIT YTHIRDAPPROX YMAG XTHIRD YUNIT YLEAST YMAG XLEAST	The graph shows the PLOTTITLE XSTART XSECOND XEND XLEAST . The YLABEL was highest in XHIGHEST with YUNIT YHIGHESTAPPROX YMAG . Since XHIGHEST it has dropped , staying at YUNIT YTHIRDAPPROX YMAG in XTHIRD and then YUNIT YLEAST YMAG in XLEAST .
T1AY YLABEL YUNIT YHIGHESTAPPROX XHIGHEST YUNIT YLEASTAPPROX XLEAST XFOURTH XLEAST YLABEL MULFOURTHLEAST YUNIT YFOURTHAPPROX XFOURTH YUNIT YLEASTAPPROX XLEAST	As the week has gone on the T1AY YLABEL has decreased . Starting at YUNIT YHIGHESTAPPROX on XHIGHEST and closing on YUNIT YLEASTAPPROX by XLEAST . \\n \\n XFOURTH to XLEAST saw the biggest drop in YLABEL , with it being MULFOURTHLEAST from YUNIT YFOURTHAPPROX on XFOURTH to YUNIT YLEASTAPPROX by XLEAST .
PLOTTITLE YHIGHEST XHIGHEST YSECOND XSECOND YTHIRD XTHIRD GRLEASTLEAST GRYLEASTLEAST T1AY	This chart shows the PLOTTITLE . There are YHIGHEST in the XHIGHEST , YSECOND in XSECOND and YTHIRD in XTHIRD . GRLEASTLEAST show as having GRYLEASTLEAST of the T1AY each
YLABEL XTHIRD XSECOND XLEAST T1AB XLEAST XTHIRD YLABEL ADDLEASTTHIRD YMAG	There is an equal increase between YLABEL from XTHIRD through XSECOND to XLEAST . T1AB with XLEAST were worse off than XTHIRD ' s YLABEL by approximately ADDLEASTTHIRD YMAG .
YLABEL T1AY T1AB T1AX XHIGHEST YHIGHEST YUNIT XSECOND YLABEL T0AX XTHIRD YLEAST YUNIT T0AX XLEAST	The highest YLABEL of T1AY in T1AB spend their T1AX XHIGHEST ( YHIGHEST YUNIT ) then XSECOND . A lower YLABEL spend their T0AX XTHIRD , with only YLEAST YUNIT spend their T0AX XLEAST .
XHIGHEST XHIGHEST YLABEL T1AY T1AY GRFOURTHLEAST YLABEL GRYFOURTHLEAST YUNIT T1AY T1AY	This chart indicates that XHIGHEST ( XHIGHEST ) spend more YLABEL on T1AY on T1AY than any other group . GRFOURTHLEAST the T1AY amount is very similar with them spending just over GRYFOURTHLEAST YUNIT T1AY on T1AY .
PLOTTITLE XTHIRD YLABEL YUNIT YTHIRDAPPROX XSECOND YUNIT YSECONDAPPROX XHIGHEST YUNIT YHIGHESTAPPROX XFOURTH YUNIT YFOURTHAPPROX XLEAST YUNIT YLEASTAPPROX	Here we see a bar chart showing PLOTTITLE . \\n On XTHIRD the YLABEL are just about YUNIT YTHIRDAPPROX , XSECOND just above YUNIT YSECONDAPPROX , XHIGHEST just under YUNIT YHIGHESTAPPROX , XFOURTH just above YUNIT YFOURTHAPPROX and XLEAST just under YUNIT YLEASTAPPROX
YLABEL YHIGHEST YUNIT XHIGHEST XLABEL XSECOND YSECONDAPPROX YUNIT XTHIRD YTHIRD YUNIT XLEAST YLEAST YUNIT	Largest YLABEL at YHIGHEST YUNIT in XHIGHEST XLABEL , then XSECOND at YSECONDAPPROX YUNIT , XTHIRD at YTHIRD YUNIT and XLEAST at only YLEAST YUNIT
YLABEL T1AX T1AY XLABEL T1AB XSECOND XHIGHEST XLABEL	This chart represents the YLABEL T1AX to T1AY certain XLABEL at T1AB . No time frame is given , but it indicates that XSECOND and XHIGHEST are the top XLABEL .
PLOTTITLE YHIGHEST XLEAST YLEASTAPPROX XLEAST SLOPEY SLOPEX	This graph shows the PLOTTITLE . The trend decreases from YHIGHEST in XLEAST to YLEASTAPPROX in XLEAST , with an average decrease of SLOPEY per SLOPEX .
GRFOURTHLEAST YLABEL T1AY GRYFOURTHLEAST YUNIT T1AY XHIGHEST YLABEL T1AY YHIGHEST YUNIT T1AY	This chart shows that GRFOURTHLEAST are spending the least YLABEL on T1AY , at just under GRYFOURTHLEAST YUNIT per T1AY . \\n \\n Whereas those aged XHIGHEST are spending the most YLABEL on T1AY at YHIGHEST YUNIT per T1AY .
PLOTTITLE XSTART XHIGHEST XEND XLEAST XLABEL XHIGHEST XLEAST XSTART XHIGHEST XEND XLEAST YHIGHESTAPPROX YUNIT XHIGHEST YLEASTAPPROX YUNIT XLEAST	This chart represents the PLOTTITLE ranging XSTART XHIGHEST XEND XLEAST . \\n \\n As you will see XSTART the chart , the highest XLABEL is XHIGHESTXEND24 years and the lowest is age 55XENDXLEAST years . \\n \\n Over the years XSTART XHIGHEST XEND XLEAST , it declines gradually XSTART YHIGHESTAPPROX YUNIT at ages XHIGHESTXEND24 XEND YLEASTAPPROX YUNIT for those aged 55XENDXLEAST years .
PLOTTITLE COUNT XLABEL YLABEL XHIGHEST YHIGHEST YUNIT XSECOND YSECOND YUNIT XTHIRD YTHIRD YUNIT XLEAST YLEAST YUNIT	The graph shows PLOTTITLE . Over COUNT XLABEL , the largest YLABEL is spent on XHIGHEST which accounts for YHIGHEST YUNIT followed by XSECOND at YSECOND YUNIT then XTHIRD at YTHIRD YUNIT and lastly XLEAST at only YLEAST YUNIT
PLOTTITLE XSTART XHIGHEST XEND XLEAST YLABEL YHIGHEST YUNIT XHIGHEST YSECOND XSECOND YTHIRD XTHIRD ADDHIGHESTFOURTH XFOURTH XEND YLEAST XLEAST XSTART XSECOND XEND XTHIRD	This chart shows the PLOTTITLE XSTART XHIGHEST XEND XLEAST . The YLABEL has fallen each year . There were YHIGHEST YUNIT in XHIGHEST , YSECOND in XSECOND , YTHIRD in XTHIRD , ADDHIGHESTFOURTH in 20ADDHIGHESTFOURTH XEND YLEAST in XLEAST . The biggest drop was XSTART XSECOND XEND XTHIRD .
PLOTTITLE XSECOND YUNIT YSECONDAPPROX YUNIT XLABEL XHIGHEST YUNIT YHIGHESTAPPROX YUNIT XLABEL XTHIRD YUNIT YTHIRDAPPROX YUNIT XLABEL XLEAST YUNIT YLEASTAPPROX YUNIT XLABEL	Here we see a bar chart of PLOTTITLE . \\n In XSECOND it was just under YUNIT YSECONDAPPROX YUNIT a XLABEL . \\n In XHIGHEST it was just above YUNIT YHIGHESTAPPROX YUNIT a XLABEL . \\n In XTHIRD it was just under YUNIT YTHIRDAPPROX YUNIT a XLABEL . \\n In YTHIRDAPPROXYLEASTAPPROX it was just above YUNIT YLEASTAPPROX YUNIT a XLABEL . \\n It is unclear according to this chart why the median has n't been consistent .
XHIGHEST XLABEL YHIGHEST YUNIT XLEAST YLEAST YUNIT XSECOND YSECOND YUNIT XLABEL	XHIGHEST is the major XLABEL at YHIGHEST YUNIT with XLEAST at YLEAST YUNIT but XSECOND is YSECOND YUNIT of leading XLABEL .
YHIGHEST YUNIT T1AY XHIGHEST YSECOND YUNIT XSECOND XTHIRD XSECOND YLABEL YTHIRD YUNIT GRLEASTLEAST GRYLEASTLEAST YUNIT	YHIGHEST YUNIT of the T1AY are in XHIGHEST , followed by YSECOND YUNIT in XSECOND . XTHIRD is close to the XSECONDan YLABEL at YTHIRD YUNIT . GRLEASTLEAST are similarly low at about GRYLEASTLEAST YUNIT .
PLOTTITLE T1AY YLABEL YHIGHESTAPPROX YUNIT XHIGHEST YSECONDAPPROX XSECOND XTHIRD YTHIRDAPPROX YUNIT T1AY XFOURTH YFOURTHAPPROX YUNIT T1AY XLEAST YLEASTAPPROX YUNIT	The graph shows the PLOTTITLE . \\n The highest T1AY YLABEL was YHIGHESTAPPROX YUNIT and came from the XHIGHEST . This was followed by YSECONDAPPROX by XSECOND . The XTHIRD spent YTHIRDAPPROX YUNIT a T1AY , the XFOURTH spent just under YFOURTHAPPROX YUNIT a T1AY and the XLEAST spent YLEASTAPPROX YUNIT .
YLABEL COUNT XLABEL PLOTTITLE YLEASTAPPROX YUNIT XLEAST YHIGHESTAPPROX YUNIT XHIGHEST YSECONDAPPROX YUNIT XSECOND	This graph depicts the YLABEL of COUNT XLABEL for PLOTTITLE . It says YLEASTAPPROX YUNIT is because of XLEAST , YHIGHESTAPPROX YUNIT is because of XHIGHEST , and COUNT5 YUNIT because of XSECOND .
YLABEL T1AB T1AX XHIGHEST YHIGHEST YUNIT XLABEL T1AX XLEAST YLEAST YUNIT	The majority of YLABEL in T1AB spend their T1AX XHIGHEST , at YHIGHEST YUNIT . The least popular XLABEL to spend the T1AX is by XLEAST , at YLEAST YUNIT .
PLOTTITLE XTHIRD YLABEL YUNIT YTHIRD XSECOND YUNIT YSECONDAPPROX XHIGHEST YUNIT YHIGHESTAPPROX YLABEL YUNIT YFOURTHAPPROX YUNIT YLEASTAPPROX XFOURTH XLEAST	The graph shows PLOTTITLE . \\n On XTHIRD the YLABEL was YUNIT YTHIRD , on XSECOND it was YUNIT YSECONDAPPROX and on XHIGHEST it was YUNIT YHIGHESTAPPROX . After that the YLABEL declined sharply to YUNIT YFOURTHAPPROX and YUNIT YLEASTAPPROX on XFOURTH and XLEAST respectively .
T1AB YLABEL XLEAST MULLEASTHIGHEST YLABEL XHIGHEST	This graph shows a trend that the higher the qualifications held by T1AB , the greater the YLABEL they receive . Those with XLEAST receive almost MULLEASTHIGHEST of the YLABEL received by those with a XHIGHEST . Education increases earning potential .
PLOTTITLE YUNIT BARNAMES XHIGHEST YLABEL XSECOND XLEAST YLABEL	The graph indicates the PLOTTITLE as a YUNIT , comparing the BARNAMES . The XHIGHEST has the largest YLABEL , followed by XSECOND and then XLEAST has the smallest YLABEL .
XHIGHEST YHIGHEST YUNIT T1AY T1AX YSECOND YUNIT XSECOND YTHIRD YUNIT XTHIRD YLEAST YUNIT XLEAST	XHIGHEST is how YHIGHEST YUNIT T1AY spend their T1AX , YSECOND YUNIT XSECOND , YTHIRD YUNIT XTHIRD and YLEAST YUNIT XLEAST
PLOTTITLE COUNT XLABEL XHIGHEST YHIGHEST YUNIT XSECOND YSECOND YUNIT XTHIRD YTHIRD YUNIT YLABEL XLEAST YLEAST YUNIT YLABEL	The following graph shows the PLOTTITLE , the COUNT XLABEL are XHIGHEST which is the highest with YHIGHEST YUNIT . XSECOND with YSECOND YUNIT , XTHIRD with YTHIRD YUNIT YLABEL and XLEAST with only YLEAST YUNIT YLABEL .
PLOTTITLE XHIGHEST YHIGHEST XSECOND YSECOND XTHIRD YTHIRD GRLEASTLEAST GRYLEASTLEAST	The graph shows the PLOTTITLE . XHIGHEST has the most at YHIGHEST , XSECOND second with YSECOND , then XTHIRD with YTHIRD and GRLEASTLEAST are joint last with GRYLEASTLEAST each .
T1AY YLABEL T1AB XSTART XLEAST XEND XHIGHEST T0AY YUNIT SLOPEY YMAG SLOPEX XLABEL	The T1AY YLABEL for T1AB has risen steadily XSTART XLEAST XEND XHIGHEST , with on T0AY a YUNIT SLOPEY YMAG increase every SLOPEY XLABEL .
PLOTTITLE XLABEL COUNT XLABEL XSECOND YSECOND YUNIT XHIGHEST YHIGHESTAPPROX YUNIT XTHIRD YTHIRD YUNIT XLEAST YLEAST YUNIT XFOURTH YFOURTH YUNIT	The graph depicts the PLOTTITLE by XLABEL across COUNT XLABELs . In XSECOND there were YSECOND YUNIT , XHIGHEST there were YHIGHESTAPPROX YUNIT , XTHIRD there were YTHIRD YUNIT , 201COUNT there were YLEAST YUNIT , and in XFOURTH there were 2COUNT YUNIT .
PLOTTITLE YUNIT ADDHIGHESTTHIRD YMAG YLABEL XTHIRD XLABEL XHIGHEST YUNIT ADDTHIRDLEAST YMAG XTHIRD XLEAST	The graphs shows the PLOTTITLE . We can see that there is an approximately YUNIT ADDHIGHESTTHIRD YMAG YLABEL difference between those with a XTHIRD XLABEL and those with a XHIGHEST but only an approximate YUNIT ADDTHIRDLEAST YMAG difference between those with a XLABEL and those XLEAST .
T1AY T1AY XLEAST YLEAST YUNIT T1AY XTHIRD YTHIRD YUNIT XSECOND YSECOND YUNIT T1AY YHIGHEST YUNIT XHIGHEST	This graph shows that T1AY are least T1AY in the XLEAST at YLEAST YUNIT . They are slightly better T1AY in the XTHIRD at YTHIRD YUNIT and better again in the XSECOND at almost YSECOND YUNIT . They are well T1AY at YHIGHEST YUNIT in XHIGHEST .
PLOTTITLE COUNT XLABEL XHIGHEST YHIGHESTAPPROX YUNIT XSECOND YSECOND YUNIT XLEAST YLEASTAPPROX YUNIT	This chart shows the PLOTTITLE of COUNT XLABEL . The largest is the XHIGHEST with YHIGHESTAPPROX YUNIT , followed by XSECOND at YSECOND YUNIT and lastly XLEAST at YLEASTAPPROX YUNIT
YLABEL T1AY XLABEL T1AB XLABEL T1AY XHIGHEST YUNIT YHIGHESTAPPROX YMAG XLEAST YUNIT YLEASTAPPROX YMAG T1AB	This chart represents YLABEL on T1AY across XLABEL in T1AB . \\n \\n The highest XLABEL in T1AY was XHIGHEST , spending YUNIT YHIGHESTAPPROX YYMAGAG . \\n \\n XLEAST spent the least , reporting spend of just under YUNIT YLEASTAPPROX YYMAGAG for the year T1AB .
PLOTTITLE XLABEL XLEAST YUNIT YLEASTAPPROX XTHIRD YUNIT YTHIRD YMAG XSECOND YUNIT YSECONDAPPROX XHIGHEST YUNIT YHIGHESTAPPROX YMAG	This graph shows PLOTTITLE by XLABEL . XLEAST spent approximately YUNIT YLEASTAPPROX YMAG ; XTHIRD comes in second with around YUNIT YTHIRD YMAG ; then XSECOND with YUNIT YSECONDAPPROX , and finally XHIGHEST with almost YUNIT YHIGHESTAPPROX YMAG .
PLOTTITLE YHIGHEST YUNIT T1AX XHIGHEST YTHIRD YUNIT XTHIRD YLEAST YUNIT XLEAST YLABEL XSECOND	This graph represents PLOTTITLE . YHIGHEST YUNIT spend their T1AX XHIGHEST , YTHIRD YUNIT spend it XTHIRD , YLEAST YUNIT are XLEAST whilst 30 YUNIT are XSECOND .
YHIGHEST YUNIT T0AB T1AY YLABEL XHIGHEST YSECOND YUNIT XSECOND YTHIRD YUNIT XTHIRD GRLEASTLEAST GRYLEASTLEAST YUNIT T0AB T1AY YLABEL	YHIGHEST YUNIT of the T0AB ' s T1AY YLABEL are in XHIGHEST , YSECOND YUNIT are in XSECOND , followed by YTHIRD YUNIT in XTHIRD . GRLEASTLEAST are each only home to GRYLEASTLEAST YUNIT of the T0AB ' s T1AY YLABEL .
YLABEL COUNT XLABEL PLOTTITLE YMAG YUNIT XLABEL XLEAST YUNIT YLEASTAPPROX YMAG XHIGHEST MULHIGHESTLEAST	This chart highlights the YLABEL COUNT XLABEL spent on PLOTTITLE , in YMAG of YUNIT . We can see that the XLABEL that spent the lowest was XLEAST , with alYMAGost YUNIT YLEASTAPPROX YMAG . XHIGHEST spent alYMAGost MULHIGHESTLEAST this .
YLABEL COUNT XLABEL YUNIT XHIGHEST YHIGHEST YUNIT XSECOND YSECONDAPPROX YUNIT XLEAST YLEASTAPPROX YUNIT	YLABEL shown in graph form to show COUNT different XLABEL against YUNIT . XHIGHEST was the highest at YHIGHEST YUNIT , XSECOND came in slightly lower at just over YSECONDAPPROX YUNIT . XLEAST was the lowest at YLEASTAPPROX YUNIT .
PLOTTITLE T0AB XHIGHEST XLABEL XSECOND XTHIRD XLEAST	This graph shows the PLOTTITLE . T0AB holding XHIGHEST XLABEL earn the highest , followed by XSECOND , then XTHIRD and finally XLEAST .
PLOTTITLE YLABEL YUNIT YHIGHESTAPPROX XHIGHEST XEND XFOURTH XLEAST YUNIT YLEASTAPPROX	This chart represents the PLOTTITLE \\n \\n There was a general increase in YLABEL to YUNIT YHIGHESTAPPROX on XHIGHEST , XEND them a dramatic drop on XFOURTH , falling further still on XLEAST to YUNIT YLEASTAPPROX .
PLOTTITLE INTERVAL XSTART XHIGHEST XEND XFIFTH YLABEL YHIGHESTAPPROX YUNIT XHIGHEST YFIFTHAPPROX YUNIT XFIFTH	This Chart represents the PLOTTITLE over INTERVAL XSTART XHIGHEST XEND XFIFTH . \\n \\n There is a downward trend in YLABEL XSTART nearly YHIGHESTAPPROX YUNIT in XHIGHEST-1994 XEND around YFIFTHAPPROX YUNIT in 2015-XFIFTH .
XHIGHEST YLABEL T1AY BARSREST YHIGHESTAPPROX YMAG YUNIT MULHIGHESTTHIRD XTHIRD YTHIRD YMAG YUNIT MULHIGHESTLEAST XLEAST YLEAST YMAG YUNIT XSECOND YLABEL YSECOND YMAG YUNIT	XHIGHEST spends a much higher YLABEL on T1AY than other BARSREST . At YHIGHESTAPPROX YMAG YUNIT , this is more than MULHIGHESTTHIRD higher than XTHIRD at YTHIRD YMAG YUNIT and over MULHIGHESTLEAST higher than XLEAST at YLEAST YMAG YUNIT . XSECOND spends the second highest YLABEL with YSECOND YMAG YUNIT .
T1AY T1AY XSECOND XHIGHEST XFOURTH XLEAST XTHIRD	T1AY are T1AY well in the XSECOND and XHIGHEST , but are significantly under-T1AY in XFOURTH , XLEAST and XTHIRD .
T1AY YLABEL T1AB INTERVAL XSTART XLABEL XLEAST XEND XHIGHEST YUNIT YLEAST YMAG XLEAST YUNIT YTHIRDAPPROX YMAG XTHIRD YUNIT YSECOND YMAG XSECOND YUNIT YHIGHESTAPPROX YMAG XHIGHEST	This graph shows how the T1AY YLABEL of T1AB has changed over time . This is done by looking every INTERVAL XSTART the XLABEL XLEAST XEND XHIGHEST . YUNIT YLEAST YMAG - XLEAST \\n YUNIT YTHIRDAPPROX YMAG - XTHIRD \\n YUNIT YSECOND YMAG - XSECOND \\n YUNIT YHIGHESTAPPROX YMAG - XHIGHEST
PLOTTITLE XHIGHEST T1AY YHIGHESTAPPROX YUNIT T1AY XSECOND T1AY YSECONDAPPROX YUNIT T1AY XTHIRD T1AY YTHIRDAPPROX YUNIT T1AY XFOURTH YFOURTHAPPROX YUNIT T1AY XLEAST T1AY YLEASTAPPROX YUNIT T1AY T1AY	The bar chart shows PLOTTITLE . XHIGHEST spent an T1AY of YHIGHESTAPPROX YUNIT on T1AY . XSECOND spent an T1AY of YSECONDAPPROX YUNIT a T1AY . XTHIRD spent an T1AY of approximately YTHIRDAPPROX YUNIT T1AY . XFOURTH spent just under YFOURTHAPPROX YUNIT T1AY whilst XLEAST spent an T1AY of approximately YLEASTAPPROX YUNIT a T1AY on T1AY .
YLABEL PLOTTITLE T1AY T0AY XLEAST YTHIRD YLABEL T0AY T1AY XTHIRD YLABEL XSECOND XHIGHEST	This chart shows the YLABEL of PLOTTITLE . We can see that there are less T1AY than T0AY working in XLEAST , and an YTHIRD YLABEL of T0AY and T1AY in XTHIRD . However there are a higher YLABEL of T1AY working in XSECOND and XHIGHEST .
PLOTTITLE XSTART XHIGHEST XEND XLEAST XHIGHEST YLABEL YHIGHEST YLEASTAPPROX XLEAST	This shows the PLOTTITLE XSTART XHIGHEST XEND XLEAST . The highest is XHIGHEST with the YLABEL at YHIGHEST gradually decreasing XEND about YLEASTAPPROX in XLEAST .
YLABEL PLOTTITLE YLABEL XLABEL XHIGHEST YHIGHEST YUNIT XSECOND YSECOND YUNIT XTHIRD YTHIRDAPPROX YUNIT YLABEL YLEASTAPPROX YUNIT XLEAST XFOURTH YFOURTH YUNIT	The chart shows the YLABEL of PLOTTITLE . \\n The highest YLABELs of women are found in the XLABEL of XHIGHEST ( YHIGHEST YUNIT ) , XSECOND ( YSECOND YUNIT ) and XTHIRD ( YTHIRDAPPROX YUNIT ) . \\n The lowest YLABEL ( YLEASTAPPROX YUNIT ) is in XLEAST while in XFOURTH the level is just over YFOURTH YUNIT .
PLOTTITLE YLABEL XHIGHEST YHIGHESTAPPROX YUNIT XSECOND YSECONDAPPROX YUNIT XLEAST YLEASTAPPROX YUNIT	This graph shows the findings of PLOTTITLE . \\n \\n The highest YLABEL was XHIGHEST at YHIGHESTAPPROX YUNIT . Next highest was XSECOND at around YSECONDAPPROX YUNIT and XLEAST the lowest , at just under YLEASTAPPROX YUNIT .
PLOTTITLE YLEAST YUNIT T1AX T1AY XLEAST YTHIRD YUNIT XTHIRD YSECOND YUNIT XSECOND YHIGHESTAPPROX YUNIT XHIGHEST	This chart shows the PLOTTITLE . YLEAST YUNIT T1AX to T1AY XLEAST ; YTHIRD YUNIT XTHIRD ; YSECOND YUNIT XSECOND , and YHIGHESTAPPROX YUNIT XHIGHEST .
PLOTTITLE XHIGHEST YLABEL YHIGHEST YUNIT XSECOND YSECOND YUNIT XLEAST YLEAST YUNIT	The chart shows PLOTTITLE . We can see that XHIGHEST accounts for a high YLABEL of this at YHIGHEST YUNIT whilst XSECOND follows at YSECOND YUNIT and XLEAST at YLEAST YUNIT .
PLOTTITLE YUNIT XLABEL YLABEL T1AB YLEASTAPPROX YUNIT XLEAST XHIGHEST YHIGHESTAPPROX YUNIT	This chart shows the PLOTTITLE in YUNIT per XLABEL . \\n From the chart we can see that the PLOTTITLE is the lowest at approximately YLEASTAPPROX YUNIT in XLEAST . The highest is XHIGHEST at YHIGHESTAPPROX YUNIT .
YHIGHEST YUNIT YLABEL XHIGHEST YLEAST YUNIT XLEAST YSECOND YUNIT XSECOND	This graph shows that YHIGHEST YUNIT of YLABEL is caused by XHIGHEST . Only YLEAST YUNIT is caused by XLEAST whilst YSECOND YUNIT is XSECOND
PLOTTITLE XHIGHEST YLABEL YHIGHESTAPPROX YUNIT YSECOND YUNIT XSECOND YLABEL YTHIRDAPPROX YUNIT XTHIRD XFOURTH YFOURTHAPPROX YUNIT YLABEL XLEAST YLEASTAPPROX YUNIT YFIFTH YUNIT XFIFTH	This graph shows by PLOTTITLE . XHIGHEST this YLABEL was just over YHIGHESTAPPROX YUNIT , this dropped to YSECOND YUNIT XSECOND . This YLABEL dropped again to around YTHIRDAPPROX YUNIT XTHIRD and there was yet another decrease XFOURTH to slightly under YFOURTHAPPROX YUNIT . The YLABEL XLEAST was just over YLEASTAPPROX YUNIT and there was then a small increase to slightly under YFIFTH YUNIT XFIFTH .
PLOTTITLE YLEAST YUNIT T1AX XLEAST XLABEL YTHIRD YUNIT T1AX XTHIRD YSECOND YUNIT T1AX XSECOND YHIGHEST YUNIT T1AY T1AX XEND XHIGHEST	The bar chart shows the PLOTTITLE . There were YLEAST YUNIT T1AX XLEAST XLABEL , approximately YTHIRD YUNIT T1AX XTHIRD and YSECOND YUNIT T1AX XSECOND . Roughly YHIGHEST YUNIT of T1AY T1AX XEND study XHIGHEST .
YLABEL PLOTTITLE XHIGHEST YLABEL YHIGHEST YUNIT XSECOND YSECOND YUNIT XTHIRD YTHIRDAPPROX YUNIT XLEAST YLABEL YLEAST YUNIT	This graph shows YLABEL PLOTTITLE . XHIGHEST has a YLABEL of YHIGHEST YUNIT (unclear if this mean YHIGHESTYUNIT of people in law firms are women) . XSECOND shows YSECOND YUNIT , XTHIRD YTHIRDAPPROX YUNIT , and XLEAST have the lowest YLABEL at YLEAST YUNIT .
YLABEL XHIGHEST YHIGHESTAPPROX YUNIT XLEAST YLEASTAPPROX YUNIT	The YLABEL is at its highest on XHIGHEST at YHIGHESTAPPROX YUNIT and gradually declines by XLEAST at YLEASTAPPROX YUNIT .
PLOTTITLE YLEAST YUNIT T1AX XLEAST YSECOND YUNIT XSECOND YHIGHEST YUNIT XHIGHEST YTHIRD YUNIT XTHIRD T1AY T1AX XHIGHEST YLABEL XLEAST	This chart shows the PLOTTITLE . YLEAST YUNIT are seen to spend their T1AX XLEAST , YSECOND YUNIT XSECOND , YHIGHEST YUNIT XHIGHEST and only YTHIRD YUNIT XTHIRD . Overall the chart shows that more T1AY spend their T1AX XHIGHEST , and the lowest YLABEL spend it XLEAST .
YLABEL T1AY XHIGHEST BARSREST XLEAST YUNIT YLEAST YMAG XTHIRD YUNIT YHIGHESTAPPROX YMAG	The chart shows that there is more YLABEL spent on T1AY in XHIGHEST than BARSREST . XLEAST has the lowest spend of YUNIT YLEAST YMAG compared to XHIGHEST spending over YUNIT YHIGHESTAPPROX YMAG
PLOTTITLE YHIGHEST T1AY XHIGHEST XLABEL YSECOND XSECOND YSECOND XSECOND YLEAST XLEAST	This graph shows PLOTTITLE . YHIGHEST of T1AY go into XHIGHEST XLABEL , a YSECOND choose XSECOND , another YSECOND XSECOND , and YLEAST choose XLEAST .
YLABEL T0AY XLABEL T1AY YLABEL XHIGHEST YHIGHEST YUNIT XSECOND YSECOND YUNIT T1AY XTHIRD YTHIRD YUNIT XFOURTH YFOURTH YUNIT XLEAST T1AY YLEASTAPPROX YUNIT	The graph depicts the YLABEL of T0AY in XLABEL who are T1AY . The greatest YLABEL of T1AY are in XHIGHEST , making up YHIGHEST YUNIT . XSECOND is YSECOND YUNIT T1AY , XTHIRD YTHIRD YUNIT , and XFOURTH YFOURTH YUNIT . XLEAST has the fewest T1AY , consisting of only YLEASTAPPROX YUNIT .
XLABEL YLABEL T1AY XHIGHEST XLABEL T1AY YHIGHEST YUNIT XLABEL YLABEL GRFOURTHLEAST	The XLABEL that spends the longest YLABEL on T1AY is the XHIGHEST XLABEL , with an T1AY of YHIGHEST YUNIT . The XLABELs that spend the least YLABEL are the GRFOURTHLEAST .
PLOTTITLE YLABEL SLOPEX XSECOND XHIGHEST XFOURTH XEND XLEAST	Here is a chart based on PLOTTITLE . It starts off at a steady YLABEL XEND rises SLOPEX on XSECOND XEND XHIGHEST at it 's highest . On XFOURTH it drops to its lowest XEND again on XLEAST .
YLABEL T1AB INTERVAL XLABEL YLABEL YHIGHEST YUNIT XHIGHEST T1AY	THis shows the YLABEL in T1AB has steadily increased over INTERVAL XLABEL . Despite this increase , the YLABEL are still low with only YHIGHEST YUNIT of parliament XHIGHEST being a T1AY .
PLOTTITLE YHIGHEST XHIGHEST XSECOND YSECOND YUNIT XTHIRD YTHIRD YUNIT GRLEASTLEAST GRYLEASTLEAST YUNIT	This graph shows PLOTTITLE . YHIGHEST of them are in XHIGHEST . XSECOND comes next with YSECOND YUNIT , followed by XTHIRD with YTHIRD YUNIT . GRLEASTLEAST ( the country ) have GRYLEASTLEAST YUNIT each .
PLOTTITLE YUNIT BARNAMES XHIGHEST YLABEL YHIGHESTAPPROX YUNIT YLABEL XLEAST YLABEL YLEAST YUNIT YLABEL T0AY	This chart shows the PLOTTITLE , by YUNIT between BARNAMES . The XHIGHEST has the largest YLABEL with over YHIGHESTAPPROX YUNIT YLABEL . XLEAST has the smallest YLABEL with only YLEAST YUNIT YLABEL in pay T0AY .
YLABEL T1AB XHIGHEST T1AX XLEAST YLEAST YUNIT XLABEL	This chart shows that the majority of YLABEL in T1AB prefer XHIGHEST in an T1AX . Although this would suggest they may prefer solitude , interestingly , they do not like XLEAST with only YLEAST YUNIT stating that as their chosen XLABEL .
PLOTTITLE XHIGHEST YHIGHESTAPPROX YUNIT T1AY XLEAST YLEASTAPPROX YUNIT T1AY	The graph shows the PLOTTITLE . XHIGHEST spent around YHIGHESTAPPROX YUNIT on T1AY compared to those who are XLEAST who only spent YLEASTAPPROX YUNIT on T1AY .
YLABEL PLOTTITLE YTHIRD YUNIT YLABEL XTHIRD XSECOND YLABEL YSECOND YUNIT XHIGHEST YHIGHESTAPPROX YUNIT XLEAST YLEASTAPPROX YUNIT	This chart shows the YLABEL of PLOTTITLE . \\n There were YTHIRD YUNIT of YLABEL XTHIRD . The XSECOND had YLABEL of about YSECOND YUNIT . XHIGHEST had slightly more with about YHIGHESTAPPROX YUNIT . However the XLEAST had the least with about YLEASTAPPROX YUNIT .
PLOTTITLE T0AX XSECOND YSECONDAPPROX YUNIT T1AY T1AY T0AX XFOURTH YFOURTHAPPROX YUNIT T0AX XLABEL XLEAST T0AX YLEASTAPPROX YUNIT T1AY XLABEL XLABEL XHIGHEST YHIGHESTAPPROX YUNIT XTHIRD YTHIRDAPPROX YUNIT	This chart shows the PLOTTITLE . From the chart , we see that T0AX around XSECOND spend YSECONDAPPROX YUNIT T1AY on T1AY , followed by T0AX XFOURTH spend around YFOURTHAPPROX YUNIT . T0AX in the XLABEL XLEAST are the lowest amount of T0AX that spend YLEASTAPPROX YUNIT on T1AY . The highest XLABEL was the XLABEL of XHIGHEST spending YHIGHESTAPPROX YUNIT while T0AX XTHIRD spent around YTHIRDAPPROX YUNIT .
PLOTTITLE XSTART XSECOND XEND XFOURTH YHIGHEST YUNIT XHIGHEST YLEAST XLEAST YFOURTH XFOURTH	Bar chart showing the PLOTTITLE XSTART XSECOND XEND XFOURTH . \\n \\n The bar chart shows a spike of YHIGHEST YUNIT in XHIGHEST , decreasing to YLEAST in XLEAST , before rising again to YFOURTH in XFOURTH .
XHIGHEST T1AY T1AY YHIGHEST YUNIT GRSECONDTHIRD GRYSECONDTHIRD YUNIT XLEAST YLEAST YUNIT T1AY	XHIGHEST seems the most popular choice for T1AY to T1AY at YHIGHEST YUNIT with GRSECONDTHIRD both at GRYSECONDTHIRD YUNIT . XLEAST is the lowest at YLEAST YUNIT of T1AY choosing to T1AY it .
COUNT XLABEL YLABEL XHIGHEST XSECOND XLEAST GRHIGHESTSECOND	This graph shows COUNT potential XLABEL , and breaks down their relative YLABEL . XHIGHEST emerges as the most important , followed by XSECOND . XLEAST is comparatively unimportant to these GRHIGHESTSECOND .
YHIGHESTAPPROX YUNIT T1AY T1AB T1AX XHIGHEST YSECOND YUNIT XSECOND YTHIRD YUNIT XTHIRD YLEAST YUNIT XLEAST	YHIGHESTAPPROX YUNIT of T1AY in T1AB spend their T1AX XHIGHEST , YSECOND YUNIT XSECOND , YTHIRD YUNIT XTHIRD and YLEAST YUNIT XLEAST .
PLOTTITLE YLABEL XHIGHEST XSECOND XTHIRD XLEAST	This graph shows PLOTTITLE . The highest YLABEL is spent XHIGHEST followed by XSECOND , XTHIRD and finally XLEAST .
PLOTTITLE YLABEL XLEAST YLEASTAPPROX YUNIT YLABEL YHIGHEST YUNIT XHIGHEST	Bar chart showing the PLOTTITLE . \\n \\n The lowest YLABEL is in the XLEAST at YLEASTAPPROX YUNIT , rising to the highest YLABEL at YHIGHEST YUNIT in XHIGHEST .
XHIGHEST YHIGHEST YUNIT T1AY XLABEL GRLEASTLEAST GRYLEASTLEAST YUNIT XSECOND XTHIRD YSECOND YTHIRD YUNIT	The graph shows XHIGHEST has over YHIGHEST YUNIT of the T1AY in each XLABEL with GRLEASTLEAST falling drastically behind with under GRYLEASTLEAST YUNIT . XSECOND and XTHIRD have YSECOND and YTHIRD YUNIT retrospectively .
PLOTTITLE COUNT T0AX XLABEL YLABEL XHIGHEST YHIGHEST YUNIT YLABEL XSECOND XLEAST YLABEL YLEASTAPPROX YUNIT YLABEL	A chart showing the PLOTTITLE in COUNT T0AX XLABEL . the YLABEL is the largest in XHIGHEST with a YHIGHEST YUNIT YLABEL although this is closely followed by the XSECOND . XLEAST has the smallest YLABEL with only a YLEASTAPPROX YUNIT YLABEL .
PLOTTITLE YHIGHEST YUNIT T0AY XHIGHEST XLABEL T0AY YSECOND YUNIT XSECOND YTHIRD YUNIT XTHIRD YFOURTH YUNIT XFOURTH YLEAST YUNIT XLEAST	This chart demonstrates PLOTTITLE . YHIGHEST YUNIT of T0AY in the XHIGHEST XLABEL are T0AY , compared to YSECOND YUNIT in XSECOND , YTHIRD YUNIT in XTHIRD , YFOURTH YUNIT in XFOURTH and YLEAST YUNIT in XLEAST . This may be because there is less emphasis placed on encouraging women into STEM subjects, and there are and underrepresentation of women in this area .
PLOTTITLE XLABEL XHIGHEST YHIGHEST YUNIT XSECOND YSECOND YUNIT XLEAST YLEAST YUNIT	this graph shows the PLOTTITLE , the greatest XLABEL is XHIGHEST with YHIGHEST YUNIT follows by XSECOND with YSECOND YUNIT and XLEAST making up the remaining YLEAST YUNIT
XHIGHEST XLABEL YHIGHEST YUNIT XSECOND YSECOND YUNIT XLEAST YLEAST YUNIT	XHIGHEST is the major XLABEL at YHIGHEST YUNIT . XSECOND plays a significant role at YSECOND YUNIT . XLEAST is only YLEAST YUNIT .
PLOTTITLE XLABEL XHIGHEST YLABEL YHIGHESTAPPROX YUNIT INTERVAL XLABEL YLABEL XFIFTH XLABEL	This chart shows the PLOTTITLE . \\n \\n In the XLABEL of XHIGHEST , the YLABEL was YHIGHESTAPPROX YUNIT , but has steadily decreased over the last INTERVAL XLABEL , before an upturn in YLABEL in the XFIFTH XLABEL .
XHIGHEST YHIGHEST YUNIT T1AY YSECOND YUNIT XSECOND XLABEL XTHIRD MULTHIRDHIGHEST XHIGHEST XLEAST YLEAST YUNIT MULLEASTSECOND XSECOND MULLEASTHIGHEST XHIGHEST	In the XHIGHEST YHIGHEST YUNIT are T1AY , followed by YSECOND YUNIT in the XSECOND XLABEL . XTHIRD is just over MULTHIRDHIGHEST of those working in the XHIGHEST . XLEAST have YLEAST YUNIT , which is MULLEASTSECOND of those working in XSECOND and MULTHIRDHIGHEST of those in XHIGHEST .
YLABEL XHIGHEST YHIGHESTAPPROX YUNIT YTHIRD YUNIT YLABEL XTHIRD XLEAST YLEASTAPPROX YUNIT	this chart demonstrates that YLABEL is largest in the XHIGHEST , at YHIGHESTAPPROX YUNIT . in comparison YTHIRD YUNIT and below of YLABEL in XTHIRD , even less is XLEAST , at YLEASTAPPROX YUNIT .
PLOTTITLE XLABEL XSTART XLEAST XEND XHIGHEST XLEAST YLEASTAPPROX YUNIT YFIFTHAPPROX YUNIT XFIFTH XFOURTH YFOURTHAPPROX YUNIT YTHIRD YUNIT XTHIRD YLABEL YSECONDAPPROX YUNIT XSECOND XEND YHIGHEST YUNIT XHIGHEST YLABEL	The above chart shows the PLOTTITLE across different ranges of XLABEL XSTART XLEAST XEND XHIGHEST . The lowest recorded was XLEAST-1994 at YLEASTAPPROX YUNIT , this rises XEND YFIFTHAPPROX YUNIT in XFIFTH , YFIFTHAPPROX000-YFIFTHAPPROX004 sees a big jump XEND 7.YFIFTHAPPROX YUNIT and YTHIRD YUNIT in YFIFTHAPPROX005-YFIFTHAPPROX009 . This YLABEL rises XEND 1YFIFTHAPPROX.8 YUNIT in YFIFTHAPPROX0YTHIRD-YFIFTHAPPROX0YHIGHEST and again rises XEND YHIGHEST YUNIT in YFIFTHAPPROX015-XHIGHEST , this has been the highest recorded showing an increasing trend on the YLABELs .
YLABEL PLOTTITLE XHIGHEST YHIGHEST YUNIT T1AY XSECOND YSECOND YUNIT XTHIRD YTHIRD YUNIT XLEAST YLEAST YUNIT	This charts shows the YLABEL of PLOTTITLE . In XHIGHEST , there are YHIGHEST YUNIT of T1AY , in XSECOND there are YSECOND YUNIT , XTHIRD YTHIRD YUNIT and in XLEAST only YLEAST YUNIT .
XLABEL YLABEL XHIGHEST XLEAST YLEAST YUNIT T1AY XLABEL XTHIRD YTHIRD YLABEL XSECOND YSECONDAPPROX	The chart shows that the XLABEL with most YLABEL is XHIGHEST . however XLEAST is the least with less than YLEAST YUNIT of T1AY in the XLABEL . XTHIRD has only a YTHIRD of YLABEL with XSECOND a little over YSECONDAPPROX .
YLABEL XLABEL T1AB XLABEL XHIGHEST YHIGHEST YUNIT XLEAST YLEASTAPPROX YUNIT XSECOND YSECOND YUNIT XFOURTH XFOURTH YUNIT XTHIRD YHIGHESTAPPROX YUNIT	YLABEL in different XLABEL in T1AB was at its highest in the XLABEL of XHIGHEST at YHIGHEST YUNIT . It was at its lowest in XLEAST at YLEASTAPPROX YUNIT . XSECOND was second highest at YSECOND YUNIT , the XFOURTH at XFOURTH YUNIT and XTHIRD at YHIGHESTAPPROX YUNIT .
XHIGHEST T1AB T1AY YLABEL YHIGHESTAPPROX YMAG YSECOND YMAG XSECOND XTHIRD YTHIRD YMAG YLEAST YMAG XLEAST	XHIGHEST saw T1AB T1AY YLABEL rise to YHIGHESTAPPROX YMAG , from YSECOND YMAG in XSECOND . XTHIRD it was at YTHIRD YMAG from YLEAST YMAG in XLEAST , so you can see it has been rising steadily
PLOTTITLE XSTART XLABEL XHIGHEST XEND XLEAST XHIGHEST YHIGHEST YUNIT XLABEL XSECOND YSECOND YUNIT XTHIRD YTHIRDAPPROX YUNIT XFOURTH YFOURTH XLEAST YLEASTAPPROX YUNIT	This bar chart shows the PLOTTITLE XSTART XLABEL XHIGHEST XEND XLEAST . \\n In XHIGHEST it was highest at YHIGHEST YUNIT across the XLABEL . In XSECOND it lowered to YSECOND YUNIT , in XTHIRD it hit just above YTHIRDAPPROX YUNIT . In 20YTHIRDAPPROX it hit YTHIRDAPPROX , and in XLEAST it hit YLEASTAPPROX YUNIT .
YLABEL XHIGHEST YHIGHEST YUNIT YLEASTAPPROX YUNIT XLEAST XSECOND YSECONDAPPROX YUNIT	The YLABEL is highest in XHIGHEST at over YHIGHEST YUNIT compared to YLEASTAPPROX YUNIT in XLEAST and just slightly more than the XSECOND at YSECONDAPPROX YUNIT . \\n Lots of factors come into play here but it is clear from this graph that XHIGHEST & the XSECOND needs to step up to close the YLABEL .
XHIGHEST YLABEL YHIGHEST YUNIT XSECOND YSECOND YUNIT XLEAST YLEAST YUNIT	XHIGHEST has the largest YLABEL at YHIGHEST YUNIT whilst XSECOND is YSECOND YUNIT and XLEAST only YLEAST YUNIT
YLABEL ADDHIGHESTLEAST YUNIT XHIGHEST XLEAST XSECOND OTHEROPERATION	The YLABEL is greatest by about ADDHIGHESTLEAST YUNIT in the XHIGHEST than in XLEAST . XSECOND is exactly OTHEROPERATION between the two countries .
PLOTTITLE YLABEL XSTART XLEAST XEND XHIGHEST XLEAST YLEASTAPPROX YUNIT YLABEL YFIFTHAPPROX YUNIT XFIFTH MULFOURTHFIFTH YFOURTHAPPROX YUNIT XFOURTH SLOPEY YUNIT SLOPEX XLABEL PLOTTITLE XLEAST YLEAST YUNIT YLABEL XHIGHEST YHIGHEST YUNIT	This chart shows PLOTTITLE . YLABEL has increased XSTART XLEAST XEND XHIGHEST . Between XLEAST-YLEASTAPPROX99SLOPEX there was under YLEASTAPPROX YUNIT YLABEL , but this increased XEND YFIFTHAPPROX YUNIT XSTART 95-99 and this MULFOURTHFIFTH XEND nearly YFOURTHAPPROX YUNIT XSTART YFIFTHAPPROX000-YFIFTHAPPROX005 . Since then there has been a YFIFTHAPPROX YUNIT rise approximately every SLOPEX XLABEL . This chart shows the minority YLABEL in the parliament of Lybia . \\n Beginning in XLEAST at less than YLEAST YUNIT , the YLABEL has grown year on year and in YFIFTHAPPROX0YLEASTAPPROX5-XHIGHEST peaked at YLEASTAPPROXSLOPEX YUNIT .
PLOTTITLE INTERVAL XLABEL XLABEL XSECOND XHIGHEST YUNIT YHIGHESTAPPROX YMAG YLABEL YUNIT YLEAST YMAG XLEAST	The PLOTTITLE per INTERVAL XLABEL started fairly high in the table in the XLABEL XSECOND and showed its highest in 200INTERVAL being YUNIT YHIGHESTAPPROX YMAG . Over the next 10 XLABEL the YLABEL soon dropped to a shocking YUNIT YLEAST YMAG by 201INTERVAL .
XHIGHEST YLABEL T1AY YHIGHEST XHIGHEST XSECOND YSECOND YUNIT T1AY YLABEL XTHIRD YTHIRD GRLEASTLEAST GRYLEASTLEAST YLABEL T1AY	The chart shows that XHIGHEST has the highest YLABEL of T1AY with YHIGHEST being on XHIGHEST . XSECOND holds YSECOND YUNIT of the T1AY YLABEL , followed by XTHIRD with YTHIRD . GRLEASTLEAST both have GRYLEASTLEAST YLABEL in the T1AY 100
PLOTTITLE YLABEL YHIGHEST YUNIT XHIGHEST YSECOND YUNIT XSECOND XTHIRD YTHIRD YUNIT XLEAST YLEAST YUNIT	This chart shows PLOTTITLE by YLABEL . YHIGHEST YUNIT XHIGHEST , YSECOND YUNIT XSECOND . The rest with XTHIRD ( YTHIRD YUNIT ) or XLEAST ( YLEAST YUNIT ) .
XLABEL YHIGHEST YUNIT T1AY XHIGHEST XLABEL XSECOND YSECOND YUNIT XTHIRD YTHIRD YUNIT XFOURTH YFOURTH YUNIT XLEAST YLEAST YUNIT T1AY XLABEL	XLABEL consist YHIGHEST YUNIT T1AY in the XHIGHEST XLABEL , XSECOND have YSECOND YUNIT , XTHIRD YTHIRD YUNIT , XFOURTH YFOURTH YUNIT but the XLEAST has only YLEAST YUNIT T1AY in the XLABEL
YLABEL T1AB XSECOND YSECOND YUNIT XHIGHEST YHIGHEST YUNIT XTHIRD YTHIRD YUNIT XLEAST YLEASTAPPROX YUNIT XFOURTH YFOURTH YUNIT	This chart shows fluctuations in YLABEL at the T1AB . In XSECOND there were YSECOND YUNIT , XHIGHEST ( YHIGHEST YUNIT ) , XTHIRD ( YTHIRD YUNIT ) , XLEAST ( YLEASTAPPROX YUNIT ) and XFOURTH YFOURTH YUNIT .
PLOTTITLE XLABEL XSECOND T1AY YSECONDAPPROX YUNIT T1AY GRYFOURTHLEAST YUNIT GRFOURTHLEAST XLABEL XHIGHEST T1AY YHIGHESTAPPROX YUNIT T1AY YTHIRDAPPROX YUNIT XLABEL XTHIRD	This chart shows the PLOTTITLE . \\n From the XLABEL of XSECOND an T1AY of YSECONDAPPROX YUNIT are spent using T1AY before a distinct drop off to GRYFOURTHLEAST YUNIT for GRFOURTHLEAST . \\n At the XLABEL of XHIGHEST the T1AY reaches its highest at YHIGHESTAPPROX YUNIT per T1AY , before again dropping down to YTHIRDAPPROX YUNIT for XLABEL XTHIRD
YLABEL T1AB T1AY COUNT XLABEL YHIGHEST YUNIT XHIGHEST YSECOND YUNIT XSECOND YLEAST YUNIT XLEAST YSECOND YUNIT XSECOND	This graph shows the YLABEL who T1AB to T1AY in COUNT different XLABEL . YHIGHEST YUNIT - XHIGHEST \\n YSECOND YUNIT - XSECOND \\n YLEAST YUNIT - XLEAST \\n YSECOND YUNIT - XSECOND
PLOTTITLE YUNIT XLABEL XLEAST YUNIT YLEASTAPPROX XHIGHEST YUNIT YHIGHESTAPPROX	This chart shows PLOTTITLE in YUNIT per XLABEL . \\n From the chart we can see that XLEAST is the lowest at approximately YUNIT YLEASTAPPROX . The highest is XHIGHEST at YUNIT YHIGHESTAPPROX
PLOTTITLE XHIGHEST YLABEL YHIGHESTAPPROX YUNIT XSECOND YSECONDAPPROX YUNIT XTHIRD YTHIRDAPPROX YUNIT XFOURTH YFOURTHAPPROX YUNIT XLEAST YLEASTAPPROX YUNIT	This chart shows PLOTTITLE . XHIGHEST spend the most YLABEL at YHIGHESTAPPROX YUNIT , followed by XSECOND at YSECONDAPPROX YUNIT , then XTHIRD at YTHIRDAPPROX YUNIT , then XFOURTH at almost YFOURTHAPPROX YUNIT and lastly XLEAST at around YLEASTAPPROX YUNIT .
YHIGHEST T1AY YLABEL XHIGHEST YSECOND YUNIT XSECOND XTHIRD XLEAST XLEAST XTHIRD YTHIRD YUNIT GRLEASTLEAST GRYLEASTLEAST YUNIT	YHIGHEST of the T1AY YLABEL in the world are in XHIGHEST . YSECOND YUNIT are in XSECOND . XTHIRD , XLEAST and XLEAST have fewer . XTHIRD with YTHIRD YUNIT and XLEAST and XLEAST both with GRYLEASTLEAST YUNIT . This would show that those with the highest quality university education study in the US or XSECOND .
PLOTTITLE GRHIGHESTSECONDTHIRD T1AY GRYHIGHESTSECONDTHIRD XLABEL GRFOURTHLEAST XLABEL T1AY GRYFOURTHLEAST XLABEL	The graph details the PLOTTITLE . The graph shows that in GRHIGHESTSECONDTHIRD T1AY make up more than GRYHIGHESTSECONDTHIRD of the XLABEL , while in the GRFOURTHLEAST XLABEL , T1AY account for less than a GRYFOURTHLEAST of the XLABEL .
XLABEL YLABEL	The higher level of XLABEL the higher the YLABEL
YHIGHEST YUNIT T1AY YLABEL XHIGHEST YSECOND YUNIT XSECOND YTHIRD YUNIT XTHIRD GRYLEASTLEAST YUNIT GRLEASTLEAST	This graph shows that YHIGHEST YUNIT of the T1AY YLABEL are in XHIGHEST , YSECOND YUNIT in XSECOND , YTHIRD YUNIT in XTHIRD with GRYLEASTLEAST YUNIT in both GRLEASTLEAST .
YLABEL BARNAMES T1AB XHIGHEST YLABEL YHIGHESTAPPROX YUNIT XLEAST YLEASTAPPROX YUNIT	The YLABEL was investigated in BARNAMES in T1AB . it was found that XHIGHEST had the highest YLABEL at YHIGHESTAPPROX YUNIT and XLEAST the lowest at YLEASTAPPROX YUNIT .
PLOTTITLE YLABEL XHIGHEST YHIGHEST YUNIT XSECOND YSECOND YUNIT XLEAST YLEAST YUNIT	This chart displays PLOTTITLE . The highest YLABEL cases would be because of XHIGHEST at YHIGHEST YUNIT , followed by XSECOND at YSECOND YUNIT and then XLEAST at YLEAST YUNIT .
XHIGHEST XLABEL YHIGHEST YUNIT XSECOND YSECOND YUNIT XLEAST YLEAST YUNIT	XHIGHEST is the leading XLABEL at YHIGHEST YUNIT , followed by XSECOND at YSECOND YUNIT and a XLEAST at YLEAST YUNIT
PLOTTITLE XSTART XSECOND XEND XFOURTH YLABEL YSECOND XSECOND YHIGHEST XHIGHEST XLABEL YLEAST XLEAST XFOURTH YLABEL XFOURTH YFOURTH	We can see from the chart the PLOTTITLE XSTART XSECOND XEND XFOURTH . The YLABEL grew from YSECOND in XSECOND to YHIGHEST in XHIGHEST . Thereafter , there has been a decline over the XLABEL down to YLEAST in XLEAST . However there has been an increase in the XFOURTH XEND the YLABEL for XFOURTH stXENDs at YFOURTH .
PLOTTITLE XLABEL T1AB XHIGHEST YHIGHESTAPPROX YMAG YUNIT XLEAST YLEASTAPPROX YMAG YUNIT XSECOND YSECONDAPPROX YMAG YUNIT XEND XTHIRD YTHIRDAPPROX YMAG YUNIT	This chart shows PLOTTITLE in different XLABEL in T1AB . XHIGHEST spent the most at YHIGHESTAPPROX YMAG YUNIT , XLEAST the least at YLEASTAPPROX YMAG YUNIT . XSECOND spent YSECONDAPPROX YMAG YUNIT XEND XTHIRD YTHIRDAPPROX YMAG YUNIT .
T1AY YLABEL T1AB XSTART XLEAST XEND XHIGHEST T1AB YLABEL	This graph presents the T1AY YLABEL of T1AB XSTART XLEAST XEND XHIGHEST . T1AB YLABEL have been steadily increasing over this time .
PLOTTITLE XHIGHEST YHIGHEST YUNIT XSECOND YSECONDAPPROX YUNIT XTHIRD YTHIRD YUNIT XLEAST YLEAST YUNIT	This chart shows PLOTTITLE the highest being XHIGHEST at YHIGHEST YUNIT then XSECOND at just above YSECONDAPPROX YUNIT then XTHIRD at YTHIRD YUNIT then XLEAST at YLEAST YUNIT
PLOTTITLE BARNAMES XHIGHEST YLABEL XSECOND XLEAST	This chart shows the PLOTTITLE between BARNAMES . We can see that the XHIGHEST has the biggest YLABEL , followed by XSECOND and XLEAST has the smallest .
PLOTTITLE XLEAST YLEAST YUNIT XHIGHEST YHIGHEST YUNIT	This chart looked at PLOTTITLE . Participation ranged from the lowest ( XLEAST at YLEAST YUNIT ) to the highest ( XHIGHEST ) at YHIGHEST YUNIT
PLOTTITLE XHIGHEST YHIGHEST XSECOND YSECOND XTHIRD YTHIRD GRLEASTLEAST GRYLEASTLEAST	this graph shows the PLOTTITLE leading is XHIGHEST with YHIGHEST , XSECOND with YSECOND , XTHIRD with YTHIRD and GRLEASTLEAST tying with GRYLEASTLEAST each . this shows that XHIGHEST and XSECOND combined have more than 80% of the top 100 universities
XHIGHEST XLABEL T1AY YHIGHESTAPPROX YMAG YUNIT XLEAST YLEAST YMAG YUNIT XTHIRD MULSECONDTHIRD YSECOND YMAG YUNIT XSECOND	XHIGHEST is the XLABEL spending the most on T1AY at over YHIGHESTAPPROX YMAG YUNIT but XLEAST only spends YLEAST YMAG YUNIT . XTHIRD only spends MULSECONDTHIRD that compared with YSECOND YMAG YUNIT of that with XSECOND .
XLEAST T1AB MULSECONDHIGHEST YUNIT YLABEL XFIFTH YFIFTHAPPROX YUNIT XFOURTH T1AY YFOURTHAPPROX YUNIT YLABEL XTHIRD YTHIRD YUNIT XSECOND YSECONDAPPROX YUNIT XHIGHEST YLABEL YHIGHEST YUNIT	XLEAST the TMULSECONDHIGHESTAB had less than MULSECONDHIGHEST YUNIT of YLABEL . Between MULSECONDHIGHEST995 and MULSECONDHIGHEST999 this increased to slightly more than YFIFTHAPPROX YUNIT . Between YFIFTHAPPROX000 and YFIFTHAPPROX004 T1AY had more than YFOURTHAPPROX YUNIT YLABEL . Between YFIFTHAPPROX005 and YFIFTHAPPROX009 this had increased to MULSECONDHIGHEST0 YUNIT and between YFIFTHAPPROX0MULSECONDHIGHEST0 and YFIFTHAPPROX0MULSECONDHIGHEST4 it was more than MULSECONDHIGHESTYFIFTHAPPROX YUNIT . By the period YFIFTHAPPROX0MULSECONDHIGHEST5 to YFIFTHAPPROX0MULSECONDHIGHEST9 the YLABEL had risen to MULSECONDHIGHEST4 YUNIT .
PLOTTITLE XHIGHEST XLEAST	This graph presents PLOTTITLE . It might be total money spent, it is not clear . XHIGHEST seems to spend the most , compared to XLEAST which spends the least .
T1AY YLABEL T1AB XLEAST T0AY YLABEL T1AB YHIGHESTAPPROX YMAG YUNIT XHIGHEST YLEAST YMAG XLEAST	This chart shows that the T1AY YLABEL for T1AB has increased continualy since XLEAST , with the T0AY YLABEL for T1AB over YHIGHESTAPPROX YMAG YUNIT in XHIGHEST , compared to YLEAST YMAG in XLEAST .
PLOTTITLE XHIGHEST XLABEL YLABEL YHIGHEST YUNIT XLABEL T1AY XSECOND YSECOND YUNIT XLABEL T1AY XHIGHEST XTHIRD YTHIRD YUNIT XFOURTH XLABEL YFOURTH YUNIT T1AY XLEAST YLEASTAPPROX YUNIT T1AY	This chart shows the PLOTTITLE . \\n \\n From the chart , we can see that XHIGHEST is the XLABEL with the highest YLABEL , with YHIGHEST YUNIT of the XLABEL being T1AY . XSECOND follows with YSECOND YUNIT of the XLABEL being T1AY , although this is a big drop from XHIGHEST . XTHIRD follows closely with YTHIRD YUNIT . \\n \\n However , after this , there is a big drop with the XFOURTH XLABEL containing only YFOURTH YUNIT of T1AY and XLEAST coming last with just YLEASTAPPROX YUNIT of T1AY .
YLABEL XHIGHEST YHIGHEST YUNIT XSECOND YSECOND YUNIT XLEAST YLEASTAPPROX YUNIT	The YLABEL in XHIGHEST is YHIGHEST YUNIT , in the XSECOND is YSECOND YUNIT and in XLEAST is YLEASTAPPROX YUNIT .
XHIGHEST T1AX T1AY	XHIGHEST is the highest factors in T1AX T1AY
YLABEL T1AB XSTART XLEAST XEND XHIGHEST YLABEL YLEASTAPPROX YUNIT XLABEL XLEAST YLABEL YHIGHEST YUNIT XLABEL XHIGHEST	We can see a definite increase in the YLABEL in the T1AB XSTART the XLABEL XLEAST XEND XHIGHEST . The YLABEL was at a low of YLEASTAPPROX YUNIT for the XLABEL XLEASTXEND1994 . Steadily those YLABEL have increased to YHIGHEST YUNIT for the XLABEL 2015XEND19 .
T1AB XLABEL XLABEL YLABEL	T1AB who achieved a higher XLABEL of further education and higher XLABEL qualification earn a higher YLABEL .
PLOTTITLE XTHIRD T1AY T1AY YUNIT YTHIRDAPPROX YUNIT YSECONDAPPROX XSECOND YUNIT YHIGHESTAPPROX XHIGHEST YUNIT YFOURTHAPPROX XFOURTH XLEAST T1AY YUNIT YLEASTAPPROX	This chart show the PLOTTITLE . \\n On XTHIRD the T1AY T1AY at YUNIT YTHIRDAPPROX , then rose to YUNIT YSECONDAPPROX on XSECOND and again rose to YUNIT YHIGHESTAPPROX on XHIGHEST . The T1AY plummeted to YUNIT YFOURTHAPPROX on XFOURTH and dropped again on XLEAST , T1AY at YUNIT YLEASTAPPROX .
XLABEL XHIGHEST YHIGHEST YUNIT YLABEL XSECOND YLABEL YSECOND YUNIT XLEAST YLEAST YUNIT YLABEL	The primary XLABEL is XHIGHEST with YHIGHEST YUNIT of YLABEL being related to this type of diet . XSECOND also contributes to significant amount of YLABEL by YSECOND YUNIT . XLEAST contributes to just YLEAST YUNIT of YLABEL .
PLOTTITLE T0AY YLEASTAPPROX YHIGHESTAPPROX YMAG YUNIT INTERVAL XHIGHEST XLEAST YLEAST YMAG	this chart demonstrates the PLOTTITLE . on T0AY this lies between YLEASTAPPROX - YHIGHESTAPPROX YMAG YUNIT over the last YLEASTAPPROX years . in XHIGHEST it was at the highest , but the graph shows in 20YLEASTAPPROX this has reduced to YLEAST YMAG .
YHIGHESTAPPROX YUNIT PLOTTITLE T1AX XHIGHEST YSECONDAPPROX YUNIT T1AY T1AX XSECOND YLEASTAPPROX YUNIT T1AX XLEAST	YHIGHESTAPPROX YUNIT of PLOTTITLE is T1AX by XHIGHEST . Approximately YSECONDAPPROX YUNIT of T1AY was T1AX by XSECOND and approximately YLEASTAPPROX YUNIT was T1AX by XLEAST .
PLOTTITLE YLABEL YHIGHEST YUNIT XHIGHEST XSECOND YSECOND YUNIT YLEAST YUNIT XLEAST	Graph shows the PLOTTITLE by YLABEL . YHIGHEST YUNIT is caused by XHIGHEST , followed by XSECOND at YSECOND YUNIT and the smallest at YLEAST YUNIT is XLEAST .
YLABEL YUNIT YLEAST YMAG YUNIT YHIGHESTAPPROX YMAG XSTART XSECOND XEND XLEAST YLABEL XHIGHEST XLEAST	The YLABEL fluctuated XSTART YUNIT YLEAST YMAG to YUNIT YHIGHESTAPPROX YMAG XSTART XSECOND XEND XLEAST , with the highest YLABEL being XHIGHEST XEND the lowest being XLEAST .
PLOTTITLE XSTART XSECOND XEND XFOURTH XSECOND YSECOND YUNIT YHIGHEST XHIGHEST XTHIRD YTHIRD XLEAST YLEAST YFOURTH XFOURTH	The graph shows PLOTTITLE XSTART XSECOND XEND XFOURTH inclusive . In XSECOND there were YSECOND YUNIT , rising to YHIGHEST in XHIGHEST but falling again in XTHIRD to YTHIRD . The number fell again in XLEAST , to YLEAST , but rose to YFOURTH in XFOURTH .
PLOTTITLE BARNAMES XHIGHEST XSECOND GRYHIGHESTSECOND YUNIT YLABEL XLEAST YLEASTAPPROX YUNIT	Bar chart showing PLOTTITLE for BARNAMES . \\n \\n Both XHIGHEST and the XSECOND have a GRYHIGHESTSECOND YUNIT YLABEL , whereas XLEAST is YLEASTAPPROX YUNIT .
PLOTTITLE XTHIRD YLABEL YUNIT YTHIRD XSECOND YUNIT YSECOND XHIGHEST YUNIT YHIGHESTAPPROX XFOURTH YLABEL YUNIT YFOURTH XEND XLEAST YUNIT YLEASTAPPROX	The graph shows PLOTTITLE . On XTHIRD the YLABEL closed at YUNIT YTHIRD , XSECOND it closed at YUNIT YSECOND , XHIGHEST was the highest closing at YUNIT YHIGHESTAPPROX . XFOURTH YLABEL closed at YUNIT YFOURTH XEND XLEAST closed at YUNIT YLEASTAPPROX .
YLABEL PLOTTITLE XHIGHEST YHIGHEST YUNIT XSECOND YSECOND YUNIT YLABEL XLEAST XLABEL YLEAST YUNIT YLABEL XTHIRD YTHIRD YUNIT	This chart represents the YLABEL of PLOTTITLE . \\n \\n As you will see XHIGHEST ( YHIGHEST YUNIT ) and XSECOND ( YSECOND YUNIT ) are the highest and almost the same YLABEL . \\n \\n XLEAST is the lowest XLABEL with YLEAST YUNIT YLABEL . XTHIRD is the 3rd at YTHIRD YUNIT .
PLOTTITLE XHIGHEST YLABEL YHIGHESTAPPROX YUNIT T1AY XLEAST YLABEL YLEASTAPPROX YUNIT T1AY YLABEL T1AY T1AY XHIGHEST XSECOND YSECONDAPPROX YUNIT ADDSECONDHIGHEST XHIGHEST XTHIRD ADDTHIRDSECOND YUNIT XSECOND XFOURTH ADDFOURTHTHIRD YUNIT XTHIRD	This graphic shows the PLOTTITLE , it is not surprise that the XHIGHEST spent most of the YLABEL with YHIGHESTAPPROX YUNIT a T1AY , neither is surprising that the XLEAST spent the less YLABEL with YLEASTAPPROX YUNIT a T1AY . The graphics shows a trend where the older the group the less YLABEL they spend T1AY on T1AY , as we can see the decline after the XHIGHEST , the following XSECOND spend about YSECONDAPPROX YUNIT , ADDSECONDHIGHEST less that the XHIGHEST , the XTHIRD spend around ADDTHIRDSECOND YUNIT less that the XHIGHEST and the XFOURTH spend around ADDFOURTHTHIRD YUNIT less that it XTHIRD .
PLOTTITLE XSECOND YLABEL YUNIT YSECONDAPPROX YMAG XHIGHEST YUNIT YHIGHESTAPPROX YMAG XTHIRD YLABEL YUNIT YTHIRDAPPROX YMAG XLEAST YUNIT YLEAST YMAG	The chart shows the PLOTTITLE . \\n In XSECOND the YLABEL was YUNIT YSECONDAPPROX YMAG . In XHIGHEST this increased to YUNIT YHIGHESTAPPROX YMAG . In XTHIRD the YLABEL fell to YUNIT YTHIRDAPPROX YMAG and in XLEAST it was the lowest at YUNIT YLEAST YMAG
PLOTTITLE YUNIT XLABEL XHIGHEST XEND XLEAST YLABEL GRHIGHESTSECOND GRFOURTHLEAST	The graph details the PLOTTITLE in YUNIT over the XLABEL ( XHIGHEST XEND XLEAST ) . The graph shows that overall , the YLABEL dropped as the week progressed , with significant drops from XHIGHEST / Tues and Thurs / XLEAST
PLOTTITLE XHIGHEST T1AY YHIGHEST XSECOND YSECOND XTHIRD YTHIRD GRLEASTLEAST YLABEL T1AY GRYLEASTLEAST	This chart shows the PLOTTITLE . XHIGHEST has the most T1AY at YHIGHEST , while XSECOND is 2nd at YSECOND and XTHIRD 3rd at YTHIRD . GRLEASTLEAST have the lowest YLABEL in the T1AY at GRYLEASTLEAST each . This could be interpreted as there being better education in XHIGHEST, however the data could also be inaccurate, as the Top 100 Universities list is made by an XHIGHESTn company, therefore may be bias towards XHIGHESTn institutions .
PLOTTITLE YLABEL YHIGHEST YUNIT XHIGHEST YSECOND YUNIT XSECOND YTHIRD YUNIT XTHIRD YLABEL YLEAST YUNIT XLEAST	The chart shows PLOTTITLE . The largest YLABEL YHIGHEST YUNIT XHIGHEST , followed by YSECOND YUNIT that XSECOND , then YTHIRD YUNIT XTHIRD and the smallest YLABEL at YLEAST YUNIT XLEAST .
PLOTTITLE XSTART XLEAST XEND XHIGHEST INTERVAL YLABEL XLEAST YLEASTAPPROX YUNIT T1AY YFIFTHAPPROX YUNIT XFIFTH YLABEL YFOURTH YUNIT YTHIRD YUNIT XTHIRD XSECOND YLABEL YSECONDAPPROX YUNIT YHIGHEST YUNIT XHIGHEST	The graph shows the PLOTTITLE , XSTART XLEAST XEND XHIGHEST , displayed in INTERVAL YLABEL increments . Between XLEAST-1994 only YLEASTAPPROX YUNIT of T1AY , increasing XEND roughly YFIFTHAPPROX YUNIT between 199INTERVAL-1999 . The YLABEL rose again roughly 7.INTERVAL YUNIT , then XEND YTHIRD YUNIT by the end of YFIFTHAPPROX009 . Between YFIFTHAPPROX0YTHIRD-YFIFTHAPPROX0YHIGHEST the YLABEL surpassed 1YFIFTHAPPROX YUNIT , reaching YHIGHEST YUNIT during YFIFTHAPPROX01INTERVAL-XHIGHEST .
PLOTTITLE XHIGHEST XLABEL YHIGHEST YUNIT T0AY XSECOND YSECOND YUNIT XLEAST XLABEL MULLEASTSECOND XSECOND YLEAST YUNIT XTHIRD YTHIRD YUNIT	The chart shows the PLOTTITLE . XHIGHEST is the most popular XLABEL with YHIGHEST YUNIT of the T0AY opting for this and XSECOND is from behind with YSECOND YUNIT . XLEAST XLABEL are MULLEASTSECOND as popular as XSECOND with YLEAST YUNIT opting for this and XTHIRD is YTHIRD YUNIT .
PLOTTITLE XSTART XSECOND XEND XFOURTH YSECOND XSECOND YFOURTH XFOURTH YHIGHEST YUNIT GRHIGHESTSECOND YLEAST XLEAST XFOURTH	The PLOTTITLE XSTART XSECOND XEND XFOURTH is demonstrated here . It shows there to be little change over time , with YSECOND in XSECOND XEND YFOURTH in XFOURTH . There was however an increase to YHIGHEST YUNIT XSTART XSECOND XEND 2013 XEND a steady decrease to YLEAST in XLEAST . This decrease started to reverse in XFOURTH .
PLOTTITLE XLABEL BARNAMES XHIGHEST YLABEL YHIGHEST YUNIT XSECOND YSECONDAPPROX YUNIT XLEAST YLABEL T1AB YLEASTAPPROX YUNIT	This chart shows the PLOTTITLE in the XLABEL BARNAMES . It shows that XHIGHEST had the biggest YLABEL at YHIGHEST YUNIT , closely followed by the XSECOND at YSECONDAPPROX YUNIT . And XLEAST had the least YLABEL in T1AB at YLEASTAPPROX YUNIT .
YLABEL COUNT XLABEL YLABEL GRHIGHESTTHIRDLEAST XFOURTH YLABEL XHIGHEST	This shows the fluctuation of YLABEL over a COUNT XLABEL . It indicates a downward trend in YLABEL between XHIGHEST and 201COUNT although this came to an end in XFOURTH . The most YLABEL were recorded in XHIGHEST .
XHIGHEST YHIGHEST YUNIT T1AY XSECOND YSECOND YUNIT T1AY XTHIRD XLEAST T1AY YTHIRD YUNIT YLEAST YUNIT T1AY	XHIGHEST are made up of YHIGHEST YUNIT T1AY and XSECOND are made up of YSECOND YUNIT T1AY . XTHIRD and XLEAST are only T1AY by YTHIRD YUNIT and YLEAST YUNIT of T1AY respectively .
PLOTTITLE XTHIRD YLABEL YUNIT YTHIRDAPPROX XSECOND YUNIT YSECONDAPPROX XHIGHEST YUNIT YHIGHESTAPPROX XFOURTH YUNIT YFOURTHAPPROX XLEAST YLABEL YUNIT YLEASTAPPROX	The chart shows PLOTTITLE . \\n \\n On XTHIRD the YLABEL was YUNIT YTHIRDAPPROX . On XSECOND it increased up to YUNIT YSECONDAPPROX . By XHIGHEST it continued to increase to YUNIT YHIGHESTAPPROX but then on XFOURTH it dropped dramatically to YUNIT YFOURTHAPPROX and by XLEAST the YLABEL dropped to only YUNIT YLEASTAPPROX .
YLABEL T1AB YUNIT YHIGHESTAPPROX XHIGHEST YLABEL YLABEL YLABEL XLEAST YUNIT YLEASTAPPROX	The YLABEL for T1AB was YUNIT YHIGHESTAPPROX on XHIGHEST showing the highest YLABEL all week . The deterioration of the YLABEL occurred throughout the week with the YLABEL on XLEAST at just YUNIT YLEASTAPPROX .
PLOTTITLE XLEAST XHIGHEST YUNIT ADDHIGHESTLEAST YMAG T0AY	This charts shows the PLOTTITLE . Not surprisingly , those with XLEAST earn the least ; and those with a XHIGHEST earn the most . There is a difference of about YUNIT ADDHIGHESTLEAST YMAG between these T0AY earnings .
YLABEL XHIGHEST XSECOND XLABEL YLABEL XLEAST XTHIRD	The chart shows that YLABEL is highest in XHIGHEST , followed by XSECOND . The XLABEL with the lowest amount of YLABEL is XLEAST , followed by XTHIRD .
PLOTTITLE XHIGHEST XLABEL YHIGHESTAPPROX YUNIT XSECOND XLEAST YSECOND YUNIT XLABEL XSECOND XHIGHEST XLABEL XLEAST YLEASTAPPROX YUNIT ADDLEASTSECOND YUNIT XSECOND XHIGHEST XLABEL COUNT XLABEL	PLOTTITLE XHIGHEST is the highest XLABEL at over YHIGHESTAPPROX YUNIT only slightly behind XSECOND and XLEAST . \\n YSECOND YUNIT XLABEL of obesity is XSECOND but XHIGHEST still play a major XLABEL . \\n XLEAST is at only YLEASTAPPROX YUNIT but only ADDLEASTSECOND YUNIT less than XSECOND . \\n Although XHIGHESTs are the highest XLABEL , all COUNT come into play when determining a XLABEL of obesity .
PLOTTITLE XSECOND XHIGHEST YLABEL YSECOND YHIGHEST YUNIT YLABEL XLEAST YLEASTAPPROX YUNIT	The PLOTTITLE is as shown by this graph . XSECOND and XHIGHEST have the largest YLABEL at YSECOND and YHIGHEST YUNIT respectively . The lowest YLABEL is in XLEAST at just over YLEASTAPPROX YUNIT .
PLOTTITLE XHIGHEST YHIGHEST YUNIT XSECOND YSECOND YUNIT YTHIRD YUNIT T1AX XTHIRD ADDSECONDLEAST YUNIT T1AX XLEAST	This chart shows PLOTTITLE . The most popular is XHIGHEST at YHIGHEST YUNIT closely followed by XSECOND at YSECOND YUNIT . YTHIRD YUNIT T1AX XTHIRD and ADDSECONDLEAST YUNIT T1AX XLEAST .
PLOTTITLE XLABEL XHIGHEST YLABEL T1AY YUNIT YHIGHESTAPPROX YMAG XLEAST YUNIT YLEASTAPPROX YMAG XSECOND YUNIT YSECONDAPPROX YMAG XTHIRD YUNIT YTHIRDAPPROX YMAG T1AY	The graph shows the PLOTTITLE in various XLABEL . In XHIGHEST the YLABEL spent on T1AY is YUNIT YHIGHESTAPPROX YMAG . In XLEAST they spent YUNIT YLEASTAPPROX YMAG . In XSECOND they spent YUNIT YSECONDAPPROX YMAG and in XTHIRD they spent YUNIT YTHIRDAPPROX YMAG on T1AY
PLOTTITLE YLABEL YHIGHESTAPPROX YHIGHEST YLEASTAPPROX XLEAST	The graph shows the PLOTTITLE . The YLABEL in YHIGHESTAPPROX was YHIGHEST . This has decrease significantly to YLEASTAPPROX in XLEAST .
YLABEL PLOTTITLE XHIGHEST YHIGHESTAPPROX YUNIT XSECOND YSECONDAPPROX YUNIT XTHIRD YTHIRD YUNIT XLEAST YLEAST YUNIT	This graph shows the YLABEL of PLOTTITLE . XHIGHEST is the highest at YHIGHESTAPPROX YUNIT , XSECOND next at YSECONDAPPROX YUNIT , then XTHIRD at YTHIRD YUNIT . XLEAST are the lowest at YLEAST YUNIT .
XHIGHEST YLABEL T1AY T1AB YUNIT YHIGHESTAPPROX YMAG XSECOND XTHIRD YUNIT YLEAST YMAG	This graph shows that XHIGHEST spent the most YLABEL on T1AY in T1AB at over YUNIT YHIGHESTAPPROX YMAG , followed by XSECOND and then XTHIRD . Africa spent the least at YUNIT YLEAST YMAG
PLOTTITLE YLABEL XHIGHEST YHIGHESTAPPROX YUNIT XSECOND YSECONDAPPROX YUNIT YLABEL XTHIRD YTHIRDAPPROX YUNIT XFOURTH T1AY YFOURTHAPPROX YUNIT T1AY YLABEL XLEAST YLEASTAPPROX YUNIT	This chart shows the PLOTTITLE . \\n \\n The highest YLABEL is spent by XHIGHEST , at YHIGHESTAPPROX YUNIT . XSECOND are lower at YSECONDAPPROX YUNIT . The YLABEL decreases again for XTHIRD at YTHIRDAPPROX YUNIT and is lower for XFOURTH , who spend on T1AY around YFOURTHAPPROX YUNIT on T1AY . The lowest YLABEL is spent by XLEAST , at around YLEASTAPPROX YUNIT .
YLABEL XHIGHEST YLEAST XLABEL XLEAST YLABEL XLABEL XHIGHEST YHIGHEST YUNIT XSECOND YSECOND XTHIRD YTHIRD XFOURTH YFOURTH	The YLABEL has decreased since XHIGHEST , arriving to YLEAST for the XLABEL XLEAST . The statistics show the following YLABEL in the following XLABELs XHIGHEST , YHIGHEST YUNIT . In XSECOND YSECOND , XTHIRD YTHIRD , XFOURTH was YFOURTH .
PLOTTITLE YLABEL XHIGHEST XSECOND XTHIRD XLEAST	Here is a chart about PLOTTITLE . The highest with YLABEL is XHIGHEST , followed by XSECOND . XTHIRD is the third highest and XLEAST at the lowest .
PLOTTITLE XLABEL YLABEL T1AY XLABEL GRFOURTHLEAST XLABEL XHIGHEST YLABEL T1AY YHIGHEST YUNIT T1AY	PLOTTITLE . \\n \\n The XLABEL that spend the least YLABEL on T1AY are the XLABEL GRFOURTHLEAST , while XLABEL XHIGHEST spend the most YLABEL on T1AY at YHIGHEST YUNIT T1AY .
PLOTTITLE GRHIGHESTSECONDTHIRD GRFOURTHLEAST	This chart shows the PLOTTITLE . There is an increase GRHIGHESTSECONDTHIRD , before a sharp decline on GRFOURTHLEAST .
T1AY T1AX XHIGHEST	Most T1AY spend their T1AX XHIGHEST
YHIGHEST YUNIT T1AY T1AY XHIGHEST XLABEL	YHIGHEST YUNIT of T1AY have chosen to T1AY XHIGHEST XLABEL
PLOTTITLE XHIGHEST YHIGHEST YUNIT XSECOND YSECOND YUNIT YLABEL GRFOURTHLEAST XLEAST XLABEL YLEASTAPPROX YUNIT XFOURTH XFOURTH YUNIT YLABEL XTHIRD XLABEL YTHIRDAPPROX YUNIT	The chart shows PLOTTITLE . XHIGHEST at YHIGHEST YUNIT and XSECOND at YSECOND YUNIT are the highest . We see YLABEL the lowest in the GRFOURTHLEAST with the XLEAST XLABEL standing at YLEASTAPPROX YUNIT and the XFOURTH at XFOURTH YUNIT . The YLABEL in the XTHIRD XLABEL is YTHIRDAPPROX YUNIT .
T1AY YLABEL T1AB XLABEL XLEAST XLABEL XHIGHEST	This graph illustrates that the T1AY YLABEL for T1AB has been increasing at a constant rate from the XLABEL XLEAST up to the XLABEL XHIGHEST .
PLOTTITLE YLABEL XHIGHEST YLABEL BARSREST	This chart show PLOTTITLE . We can see that a high YLABEL choose XHIGHEST whilst a much lower YLABEL choose BARSREST .
PLOTTITLE COUNT XLABEL BARNAMES YLABEL YUNIT YSECONDAPPROX YMAG XSECOND YUNIT YHIGHESTAPPROX YMAG XHIGHEST XEND YUNIT YTHIRDAPPROX YMAG XTHIRD XLEAST XEND YUNIT YLEAST YMAG	This graph shows the PLOTTITLE over COUNT XLABEL , BARNAMES . YLABEL increased from YUNIT YSECONDAPPROX YMAG in 2YMAG XEND YUNIT YHIGHESTAPPROX YMAG in XHIGHEST but have fallen since XEND just under YUNIT YTHIRDAPPROX YMAG in YTHIRDAPPROX10 falling further in YTHIRDAPPROX15 XEND YUNIT YLEAST YMAG .
YLABEL T1AB XTHIRD ADDHIGHESTTHIRD YUNIT YLABEL XLABEL XHIGHEST YHIGHESTAPPROX YUNIT ADDSECONDHIGHEST YUNIT XLABEL XSECOND XLABEL XTHIRD YLABEL YTHIRDAPPROX YUNIT YLABEL BARSREST XFOURTH YLABEL YFOURTHAPPROX YUNIT YLEASTAPPROX YUNIT XLEAST XFIFTH XLABEL ADDFIFTHLEAST YUNIT	The YLABEL in the T1AB has reduced a lot by the XTHIRD by more of ADDHIGHESTTHIRD YUNIT . It had a good YLABEL in the XLABEL XHIGHEST of YHIGHESTAPPROX YUNIT , although this was reduced by ADDSECONDHIGHEST YUNIT in the XLABEL 199ADDHIGHESTTHIRD-1999 , it was still a good number . \\n In the XLABEL XTHIRD-2004 a big jump can be seem where there YLABEL was only YTHIRDAPPROX YUNIT , YLABEL being reduced in the BARSREST XLABEL . In 200ADDHIGHESTTHIRD-2009 the YLABEL was YFOURTHAPPROX YUNIT , going further down to YLEASTAPPROX YUNIT for XLEAST . Since then we can see a little increase for the 201ADDHIGHESTTHIRD-2019 XLABEL of ADDFIFTHLEAST YUNIT , which could be very slow increase in the XLABEL to come .
YLABEL XLABEL T1AB YLABEL XHIGHEST YUNIT YHIGHESTAPPROX YMAG YLABEL XSECOND YSECOND YMAG XTHIRD YLABEL YUNIT YTHIRD YMAG XLEAST YUNIT YLEAST YMAG	YLABEL across several XLABEL in the T1AB . The highest YLABEL spent was from XHIGHEST at a cost of just over YUNIT YHIGHESTAPPROX YMAG . The YLABEL spent in XSECOND was YSECOND YMAG . In XTHIRD , the YLABEL was YUNIT YTHIRD YMAG and finally XLEAST came in at YUNIT YLEAST YMAG .
YHIGHESTAPPROX YMAG YUNIT T1AY T1AB XHIGHEST YSECOND XSECOND YTHIRD XTHIRD YLEAST YMAG XLEAST	YHIGT1AYSTAPPROX YMAG YUNIT was spent on T1AY in T1AB in XHIGHEST , YSECOND in XSECOND , YTHIRD in XTHIRD but only YLEAST YMAG in XLEAST
PLOTTITLE YLABEL XLABEL XHIGHEST XLABEL YUNIT XLEAST YLEASTAPPROX YUNIT T1AY	Here is a chart showing the PLOTTITLE . \\n The highest YLABEL is for the XLABEL of XHIGHEST . Each XLABEL moving forward is reduced in YUNIT . The lowest is XLEAST with approximately YLEASTAPPROX YUNIT per T1AY .
PLOTTITLE YHIGHEST YUNIT T1AY T1AX XHIGHEST XLABEL XLABEL XLEAST YLEAST YUNIT	This bar chart shows PLOTTITLE . YHIGHEST YUNIT of T1AY spend their T1AX XHIGHEST ( the most common XLABEL ) , while the least common XLABEL is XLEAST ( ~ YLEAST YUNIT ) . it is unclear if T1AY could say that they do more than one of these things .
PLOTTITLE XLABEL YLABEL XLABEL XLABEL XHIGHEST YLABEL T1AY YHIGHEST YUNIT XLEAST XLABEL YLEASTAPPROX YUNIT	The graph details the PLOTTITLE . \\n The graph is broken down by XLABEL showing YLABEL spent per XLABEL . XLABEL XHIGHEST showed the highest YLABEL T1AY YHIGHEST YUNIT , while the XLEAST XLABEL showed the least , T1AY just over YLEASTAPPROX YUNIT .
PLOTTITLE YLABEL XLEAST YLEASTAPPROX YUNIT T1AY XSECOND YSECONDAPPROX YUNIT T1AY XHIGHEST XLABEL YHIGHESTAPPROX YUNIT XLABEL	This chart shows the PLOTTITLE and the YLABEL . XLEAST account for just under YLEASTAPPROX YUNIT of T1AY , followed by XSECOND which accounts for YSECONDAPPROX YUNIT of T1AY , but XHIGHEST is the highest XLABEL accounting for YHIGHESTAPPROX YUNIT of the cause of T1AY .
XHIGHEST YLABEL YHIGHEST YUNIT XLEAST YLEAST YUNIT YLABEL XSECOND ADDSECONDHIGHEST YUNIT XHIGHEST	Surprisingly the XHIGHEST has the largest YLABEL at YHIGHEST YUNIT while XLEAST has a mere YLEAST YUNIT YLABEL . XSECOND has ADDSECONDHIGHEST YUNIT lower than the XHIGHEST's despite its poor Maternity packages .
PLOTTITLE COUNT XLABEL BARNAMES YLABEL XLABEL YTHIRD YUNIT XTHIRD YSECONDAPPROX YUNIT XSECOND YHIGHEST YUNIT XHIGHEST YLEAST YUNIT XLEAST	We have here a bar chart representing PLOTTITLE . \\n It is divided into COUNT XLABEL : BARNAMES . \\n The YLABEL across these XLABEL starts at YTHIRD YUNIT for the XTHIRD , just over YSECONDAPPROX YUNIT for XSECOND , YHIGHEST YUNIT for XHIGHEST and YLEAST YUNIT for XLEAST .
YHIGHEST YUNIT T1AY T1AX XHIGHEST YSECOND YUNIT XSECOND YTHIRD YUNIT XTHIRD YLEAST YUNIT T0AX XLEAST T1AX	YHIGHEST YUNIT of T1AY spend their T1AX XHIGHEST , YSECOND YUNIT prefer to XSECOND , YTHIRD YUNIT XTHIRD and only YLEAST YUNIT choose to spend T0AX XLEAST in the T1AX
PLOTTITLE YLABEL YHIGHEST XHIGHEST YSECOND XSECOND YTHIRD XTHIRD YFOURTH XFOURTH YLABEL YLEASTAPPROX XLEAST	The chart shows the PLOTTITLE . \\n The highest YLABEL was YHIGHEST in XHIGHEST which decreased to YSECOND in XSECOND , YTHIRD in XTHIRD , YFOURTH in 20YFOURTH and the lowest YLABEL was YLEASTAPPROX in 20YTHIRD .
T1AY GRHIGHESTSECOND T1AX XLABEL GRFOURTHLEAST	T1AY are more likely to work in the GRHIGHESTSECOND in T1AX XLABEL compared to GRFOURTHLEAST
YLABEL T1AB T1AY T1AX T1AY XHIGHEST YHIGHESTAPPROX YUNIT YLEAST YUNIT T1AY T1AX XEND T1AY XLEAST	The graph shows the YLABEL at T1AB . Most T1AY T1AX XEND T1AY XHIGHEST with YHIGHESTAPPROX YUNIT and only YLEAST YUNIT of T1AY T1AX XEND T1AY XLEAST .
PLOTTITLE XHIGHEST YHIGHEST T1AY YLABEL XLEAST YLEASTAPPROX	This graph displays the PLOTTITLE . The data presumably comes from a ranking source but this information is not provided . XHIGHEST has YHIGHEST the T1AY YLABEL , while XLEAST only has YLEASTAPPROX .
PLOTTITLE XSTART XLEAST XEND XHIGHEST XLABEL XLEAST YLEASTAPPROX YUNIT YLABEL XFIFTH YFIFTHAPPROX YUNIT YLABEL XFOURTH YFOURTHAPPROX YUNIT YLABEL XTHIRD YTHIRD YUNIT YLABEL XSECOND YSECONDAPPROX YUNIT YLABEL XHIGHEST YHIGHEST YUNIT YLABEL YLABEL	This chart shows the PLOTTITLE XSTART XLEAST XEND XHIGHEST . \\n In the XLABEL XLEAST XEND 1994 there were YLEASTAPPROX YUNIT of YLABEL , in 1995 XEND 1999 there were YFIFTHAPPROX YUNIT of YLABEL , YFIFTHAPPROX000 XEND YFIFTHAPPROX004 there were 7.YFIFTHAPPROX YUNIT of YLABEL , YFIFTHAPPROX005 XEND YFIFTHAPPROX009 there were YTHIRD YUNIT of YLABEL , YFIFTHAPPROX0YTHIRD XEND YFIFTHAPPROX0YHIGHEST there were 1YFIFTHAPPROX.4 YUNIT of YLABEL , YFIFTHAPPROX015 XEND XHIGHEST there were YHIGHEST YUNIT of YLABEL . Over the XLABEL there is an explicit scene of an increase in YLABEL .
YHIGHEST T1AY YLABEL XHIGHEST YSECOND YUNIT XSECOND XTHIRD YTHIRD YUNIT T1AY YLABEL GRLEASTLEAST YUNIT GRYLEASTLEAST YUNIT	YHIGHEST of the worlds T1AY YLABEL are XHIGHEST , followed by YSECOND YUNIT being XSECOND . XTHIRD contributes YTHIRD YUNIT of the T1AY YLABEL and GRLEASTLEAST contribute the lowest YUNIT with just GRYLEASTLEAST YUNIT each .
PLOTTITLE XHIGHEST T0AB T1AY YLABEL XSECOND T0AB XTHIRD XLEAST T0AB MULLEASTHIGHEST XHIGHEST T0AB	This graph plots the PLOTTITLE . XHIGHEST T0AB earn the highest T1AY YLABEL , followed by XSECOND T0AB , then XTHIRD . XLEAST T0AB earn about MULLEASTHIGHEST what XHIGHEST T0AB do .
PLOTTITLE XLABEL XHIGHEST YHIGHESTAPPROX YUNIT XSECOND YSECONDAPPROX YUNIT XLEAST YLEASTAPPROX YUNIT	This graph shows PLOTTITLE . THe most common XLABEL is XHIGHEST with YHIGHESTAPPROX YUNIT followed by XSECOND at YSECONDAPPROX YUNIT and XLEAST as YLEASTAPPROX YUNIT
T1AY XHIGHEST XLABEL YHIGHEST YUNIT GRSECONDTHIRD GRYSECONDTHIRD YUNIT XLEAST YLEAST YUNIT	Most T1AY choose XHIGHEST XLABEL at YHIGHEST YUNIT whilst GRSECONDTHIRD only attract GRYSECONDTHIRD YUNIT , and XLEAST is least popular at YLEAST YUNIT .
XHIGHEST YLABEL BARSREST	Those who have a XHIGHEST do better in terms of YLABEL than BARSREST
XHIGHEST XLABEL XSECOND XLEAST	This chart shows that XHIGHEST is the most likely XLABEL on average , followed by XSECOND , and is least likely to be caused by XLEAST .
YLABEL T1AB INTERVAL XLABEL XHIGHEST YHIGHEST YUNIT YLEAST YUNIT XLEAST	this chart shows the YLABEL at the T1AB has decreased over INTERVAL XLABEL . In XHIGHEST , there were YHIGHEST YUNIT and this has reduced year by year , to YLEAST YUNIT in XLEAST .
YHIGHESTAPPROX YMAG T1AY YLABEL T1AB XHIGHEST YSECONDAPPROX YMAG XSECOND YTHIRDAPPROX YMAG XTHIRD XLABEL YLEAST YMAG XLEAST	YHIGHESTAPPROX YMAG is T1AY YLABEL for T1AB who have a XHIGHEST , YSECONDAPPROX YMAG for a XSECOND , YTHIRDAPPROX YMAG for a XTHIRD XLABEL , but only YLEAST YMAG with no XLABEL
YLABEL PLOTTITLE T1AY GRHIGHESTSECOND XLABEL GRFOURTHLEAST	The graph shows the YLABEL of PLOTTITLE . We can see that they are most T1AY in GRHIGHESTSECOND XLABEL but least T1AY in GRFOURTHLEAST .
YLABEL T1AY T1AB XHIGHEST XLABEL T1AY YLABEL YHIGHESTAPPROX YUNIT XSECOND XLABEL YSECONDAPPROX YUNIT YLABEL XLEAST XLABEL YLEASTAPPROX YUNIT XTHIRD XLABEL YTHIRDAPPROX YUNIT XFOURTH XLABEL YFOURTHAPPROX YUNIT	The chart indicates the YLABEL spent on T1AY in T1AB was greatest in the XHIGHEST XLABEL showing an T1AY YLABEL of YHIGHESTAPPROX YUNIT . Closely behind were the XSECOND XLABEL at YSECONDAPPROX YUNIT . The least amount of YLABEL was spent by the XLEAST XLABEL totalling YLEASTAPPROX YUNIT . The XTHIRD XLABEL came in at YTHIRDAPPROX YUNIT and the XFOURTH XLABEL at YFOURTHAPPROX YUNIT .
PLOTTITLE XSTART XHIGHEST XEND XLEAST XHIGHEST YHIGHEST YUNIT YSECOND XSECOND XTHIRD YTHIRD XFOURTH YFOURTH YUNIT XLEAST YLABEL YLEAST	This chart shows the PLOTTITLE XSTART XHIGHEST XEND XLEAST . \\n In XHIGHEST there were YHIGHEST YUNIT . YSECOND were recorded in XSECOND . It decreased further in XTHIRD at YTHIRD . In XFOURTH there was just a slight drop at YFOURTH YUNIT . However in XLEAST it shows the lowest YLABEL at YLEAST .
PLOTTITLE XSTART XHIGHEST XEND XFIFTH INTERVAL XLABEL YHIGHESTAPPROX YUNIT XHIGHEST YFIFTH YUNIT XFIFTH	This chart represents PLOTTITLE XSTART XHIGHEST XEND XFIFTH , in periods of INTERVAL XLABEL at a time . We can see that there has been a decrease over time , XSTART almost 1INTERVAL YUNIT in XHIGHEST-199INTERVAL XEND almost YFIFTH YUNIT in 2015-XFIFTH .
PLOTTITLE XHIGHEST YLABEL YHIGHEST YUNIT XSECOND YLABEL YSECOND YUNIT XTHIRD YLABEL YTHIRDAPPROX YUNIT XFOURTH YLABEL YFOURTHAPPROX YUNIT XLEAST YLABEL YLEASTAPPROX YUNIT XFIFTH YLABEL YFIFTH YUNIT	The bar chart shows PLOTTITLE . XHIGHEST there was a YLABEL of roughly YHIGHEST YUNIT , XSECOND there was a YLABEL of YSECOND YUNIT , XTHIRD there was a YLABEL of roughly YTHIRDAPPROX YUNIT . XFOURTH there was a YLABEL of just under YFOURTHAPPROX YUNIT , XLEAST there was a YLABEL of roughly YLEASTAPPROX YUNIT . Finally , XFIFTH there was a YLABEL of just under YFIFTH YUNIT .
PLOTTITLE YLABEL YUNIT YHIGHESTAPPROX XHIGHEST YUNIT YLEASTAPPROX XLEAST	Bar chart PLOTTITLE . \\n \\n The YLABEL decrease as the week progresses ; from YUNIT YHIGHESTAPPROX on XHIGHEST , to YUNIT YLEASTAPPROX on XLEAST .
PLOTTITLE YLABEL XHIGHEST YHIGHESTAPPROX YUNIT YLABEL XLEAST YLEAST YUNIT	This chart shows a PLOTTITLE . \\n From the chart we see that the highest YLABEL is in XHIGHEST at YHIGHESTAPPROX YUNIT . We can see that the lowest YLABEL is in XLEAST at YLEAST YUNIT
XHIGHEST YLABEL T1AB YHIGHEST YUNIT YLABEL XLABEL XLEAST YLABEL YLEASTAPPROX YUNIT	XHIGHEST has the highest YLABEL at T1AB with YHIGHEST YUNIT of YLABEL on this XLABEL . \\n \\n XLEAST has the lowest YLABEL at YLEASTAPPROX YUNIT .
PLOTTITLE XHIGHEST T1AY YUNIT YHIGHESTAPPROX XSECOND YUNIT YSECONDAPPROX GRTHIRDFOURTH YUNIT GRYTHIRDFOURTH XLEAST YLABEL MULFOURTHLEAST YUNIT YLEASTAPPROX	The chart shows the PLOTTITLE . \\n On XHIGHEST the T1AY closes at over YUNIT YHIGHESTAPPROX , falling on XSECOND to end at under YUNIT YSECONDAPPROX . GRTHIRDFOURTH see a continuing decline to around YUNIT GRYTHIRDFOURTH and finally on XLEAST the YLABEL drops significantly , MULFOURTHLEAST to just under YUNIT YLEASTAPPROX .
T1AY YLABEL XHIGHEST BARSREST	There are more T1AY YLABEL in XHIGHEST than BARSREST in the world .
PLOTTITLE XLABEL YLABEL T1AY YHIGHEST YUNIT YHIGHEST YUNIT XHIGHEST XLABEL XSECOND XLABEL YSECONDAPPROX YUNIT T1AY T1AY XLABEL YLABEL GRFOURTHLEAST XLABEL T1AY GRYFOURTHLEAST YUNIT T1AY T1AY XTHIRD XTHIRD T1AY YTHIRD YUNIT T1AY	This chart shows the PLOTTITLE . \\n We can see in the chart that the XLABEL that spends the most YLABEL on T1AY - nearly YHIGHEST YUNIT or YHIGHEST YUNIT - is XHIGHEST . The second highest XLABEL are in the XSECOND XLABEL which spends about YSECONDAPPROX YUNIT on T1AY on T1AY . The lowest XLABEL by YLABEL are in the YSECONDAPPROX5-34 and 35-44 age XLABELs , which use T1AY for around GRYFOURTHLEAST YUNIT each T1AY on T1AY . The oldest XLABEL , XTHIRD , uses T1AY for more than YTHIRD YUNIT T1AY .
YLABEL PLOTTITLE YLABEL XHIGHEST YHIGHESTAPPROX YUNIT YLEAST YUNIT YLABEL XLEAST YLABEL XSECOND YSECOND YUNIT YTHIRD YUNIT XTHIRD	The graph shows the YLABEL of PLOTTITLE . Most YLABEL in XHIGHEST with YHIGHESTAPPROX YUNIT and there are only YLEAST YUNIT of YLABEL in the XLEAST . The second highest YLABEL was XSECOND with YSECOND YUNIT followed by with YTHIRD YUNIT in XTHIRD .
YLABEL XLABEL YLABEL GRHIGHESTSECONDTHIRD XHIGHEST YLABEL YHIGHEST YUNIT XSECOND YSECOND YUNIT YLABEL XTHIRD YTHIRDAPPROX YUNIT YLABEL YFOURTH YUNIT T1AY T1AY XFOURTH YLEASTAPPROX YUNIT XLEAST GRFOURTHLEAST GRHIGHESTSECONDTHIRD	This chart shows the YLABEL enrolled in XLABEL . The YLABEL is highest within GRHIGHESTSECONDTHIRD , with XHIGHEST showing the highest YLABEL at YHIGHEST YUNIT , followed by XSECOND with a YSECOND YUNIT YLABEL and XTHIRD with YTHIRDAPPROX YUNIT of YLABEL . Only YFOURTH YUNIT of T1AY are now T1AY in XFOURTH and YLEASTAPPROX YUNIT in XLEAST , indicating a decline in XFOURTH and Humanities in favour GRHIGHESTSECONDTHIRD
XHIGHEST T1AY YLABEL YHIGHEST XSECOND YSECOND XTHIRD YTHIRD GRLEASTLEAST GRYLEASTLEAST	the table shows that XHIGHEST has the most T1AY YLABEL ( YHIGHEST ) , followed by XSECOND ( YSECOND ) , XTHIRD ( YTHIRD ) , GRLEASTLEAST draw with about GRYLEASTLEAST each .
YLABEL T1AY GRHIGHESTSECONDTHIRD XFOURTH YLABEL XLEAST XFOURTH YLABEL YUNIT YLEASTAPPROX YLABEL YUNIT YHIGHESTAPPROX XHIGHEST	The YLABEL for T1AY were on the rise for the GRHIGHESTSECONDTHIRD , but on XFOURTH there was a huge drop in the YLABEL . XLEAST was even worse than XFOURTH , with the YLABEL sitting at just YUNIT YLEASTAPPROX , a far cry from the YLABEL of YUNIT YHIGHESTAPPROX that they were sitting at on XHIGHEST .
XHIGHEST XLABEL YLABEL T1AY YHIGHEST YLABEL XSECOND YSECOND YLABEL XTHIRD YTHIRD GRLEASTLEAST GRYLEASTLEAST	XHIGHEST is the XLABEL with most YLABEL in the T1AY table with YHIGHEST YLABEL . XSECOND comes next with YSECOND YLABEL , XTHIRD has YTHIRD , whilst GRLEASTLEAST have only GRYLEASTLEAST each .
PLOTTITLE XTHIRD YLABEL YTHIRDAPPROX XSECOND YSECONDAPPROX XHIGHEST YHIGHESTAPPROX XFOURTH YFOURTHAPPROX XLEAST YLEASTAPPROX	This chart shows the PLOTTITLE . On XTHIRD the YLABEL was just over YTHIRDAPPROX . XSECOND was just over YSECONDAPPROX . XHIGHEST was around YHIGHESTAPPROX . XFOURTH showed a huge drop at over YFOURTHAPPROX and XLEAST showed the least at below YLEASTAPPROX .
PLOTTITLE XLEAST XLABEL XLABEL YLEAST YUNIT XTHIRD YTHIRD YUNIT YSECOND YUNIT T1AY XSECOND XHIGHEST XLABEL YHIGHEST YUNIT	The chart shows PLOTTITLE . \\n \\n XLEAST XLABEL is the least popular XLABEL with YLEAST YUNIT . \\n XTHIRD YTHIRD YUNIT . \\n YSECOND YUNIT of T1AY opted XSECOND and XHIGHEST is the popular XLABEL at YHIGHEST YUNIT .
T1AY T1AX XHIGHEST XLEAST T1AY T0AX	The chart shows that the majority of T1AY spend their T1AX XHIGHEST . XLEAST is the least popular way for T1AY to spend their T0AX
PLOTTITLE COUNT T0AX XLABEL BARNAMES T1AB YLABEL GRHIGHESTSECOND GRYHIGHESTSECOND YUNIT XLEAST YLEASTAPPROX YUNIT	The chart shows the PLOTTITLE in COUNT T0AX XLABEL - BARNAMES . \\n In that T1AB the YLABEL is similar in GRHIGHESTSECOND at just over GRYHIGHESTSECOND YUNIT . In XLEAST it stands at YLEASTAPPROX YUNIT .
PLOTTITLE YLABEL YHIGHEST YUNIT XHIGHEST YSECOND YUNIT XSECOND YTHIRD YUNIT XTHIRD YLEAST YUNIT XLEAST	The graph shows the PLOTTITLE . \\n The highest YLABEL was YHIGHEST YUNIT in the XHIGHEST followed by YSECOND YUNIT in the XSECOND , YTHIRD YUNIT in XTHIRD and finally YLEAST YUNIT in XLEAST
PLOTTITLE XLABEL XHIGHEST YHIGHESTAPPROX YUNIT GRSECONDLEAST XLABEL GRSECONDLEAST XLABEL GRYSECONDLEAST YUNIT T1AY XSECOND YSECONDAPPROX YUNIT XLEAST YLEASTAPPROX YUNIT	PLOTTITLE is seen here . The biggest XLABEL is XHIGHEST at YHIGHESTAPPROX YUNIT . However GRSECONDLEAST are a larger XLABEL with GRSECONDLEAST combined shown to XLABEL obesity in GRYSECONDLEAST YUNIT of T1AY . \\n This is broken down into XSECOND at YSECONDAPPROX YUNIT and XLEAST at YLEASTAPPROX YUNIT .
T1AY T1AY XHIGHEST YHIGHEST YUNIT XSECOND YSECOND YUNIT XTHIRD YTHIRD YUNIT XLEAST YLEAST YUNIT	The table shows that T1AY are most T1AY in XHIGHEST ( YHIGHEST YUNIT ) , followed by XSECOND ( YSECOND YUNIT ) , XTHIRD ( YTHIRD YUNIT ) , and XLEAST ( YLEAST YUNIT ) .
YHIGHEST YUNIT T1AY T1AY XHIGHEST XLABEL MULSECONDHIGHEST YSECOND YUNIT XSECOND YSECOND YUNIT XSECOND XLEAST YLABEL YLEAST YUNIT	YHIGHEST YUNIT of T1AY chose to T1AY the XHIGHEST XLABEL , less than MULSECONDHIGHEST that number - YSECOND YUNIT chose XSECOND and YSECOND YUNIT XSECOND . XLEAST has the least YLABEL it - YLEAST YUNIT
COUNT PLOTTITLE YLABEL XLABEL XHIGHEST T1AX YHIGHESTAPPROX YUNIT XSECOND YSECONDAPPROX YUNIT XLEAST T1AX YLEASTAPPROX YUNIT T0AY	The graph shows COUNT PLOTTITLE , as a YLABEL of incidence . The most common XLABEL is XHIGHEST , identified as T1AX YHIGHESTAPPROX YUNIT , with XSECOND second at YSECONDAPPROX YUNIT . XLEAST is third , T1AX YLEASTAPPROX YUNIT of T0AY .
PLOTTITLE XLABEL YLABEL GRFOURTHLEAST GRYFOURTHLEAST YUNIT XLABEL XHIGHEST YHIGHEST YUNIT T1AY T1AY	This chart shows the PLOTTITLE . The XLABEL that spent least YLABEL were the GRFOURTHLEAST who spent under GRYFOURTHLEAST YUNIT . The highest XLABEL was the XHIGHEST who spent nearly YHIGHEST YUNIT per T1AY on T1AY .
T1AY YLABEL T1AB XLABEL INTERVAL XLABEL INTERVAL XLABEL ADDHIGHESTLEAST YMAG YUNIT	The T1AY YLABEL of T1AB per XLABEL is gradually and steadily rising every INTERVAL XLABELs . In the last 1INTERVAL XLABELs it has risen 1INTERVAL YMAG YUNIT .
T1AB T1AX XHIGHEST YHIGHEST YUNIT T1AY T1AY XLABEL XSECOND YSECOND YUNIT XTHIRD YTHIRD YUNIT XFOURTH YLEASTAPPROX YUNIT XLEAST	In T1AB T1AX of XHIGHEST spend around YHIGHEST YUNIT T1AY on T1AY , more than any other XLABEL . Next are XSECOND with YSECOND YUNIT , followed by XTHIRD with YTHIRD YUNIT . XFOURTH spend YLEASTAPPROX YUNIT , about the same as XLEAST .
YLABEL XSTART XTHIRD XEND XLEAST GRHIGHESTSECONDTHIRD YLABEL XEND YLABEL YUNIT YHIGHESTAPPROX XHIGHEST GRFOURTHLEAST YLABEL YLABEL YUNIT YLEASTAPPROX XLEAST	The YLABEL XSTART XTHIRD XEND XLEAST have been unusual . During the first GRHIGHESTSECONDTHIRD , the YLABEL seemed XEND be fairly high being at a YLABEL of YUNIT YHIGHESTAPPROX on XHIGHEST . However , for the next GRFOURTHLEAST it looks like the sXENDck YLABEL dropped dramatically having a YLABEL of only YUNIT YLEASTAPPROX on XLEAST .
PLOTTITLE YLABEL T1AY T1AY XHIGHEST YUNIT T1AY T1AY XLEAST YUNIT T1AY	As you can see this graph shows the PLOTTITLE . \\n \\n The graph shows that the older you are in years the less YLABEL you spend on T1AY T1AY , for example XHIGHEST spend 180 YUNIT on T1AY T1AY where as XLEAST spend only 70 YUNIT a T1AY .
PLOTTITLE YHIGHEST YUNIT XHIGHEST T1AY YSECOND YUNIT XSECOND YTHIRD YUNIT XTHIRD YFOURTH YUNIT XFOURTH YLEAST XLEAST	this chart shows PLOTTITLE showing that YHIGHEST YUNIT of those who work in XHIGHEST are T1AY , YSECOND YUNIT in XSECOND , YTHIRD YUNIT XTHIRD , YFOURTH YUNIT in XFOURTH and YLEAST XLEAST . contributing and enforcing the stereotype that that heavily intellectual subjects are man dominated and more creative subjects are women areas .
PLOTTITLE XLABEL XSECOND YSECONDAPPROX YUNIT T1AY XLABEL XFOURTH YFOURTHAPPROX YUNIT T1AY XLABEL XLEAST YLEASTAPPROX YUNIT T1AY XLABEL XHIGHEST YHIGHESTAPPROX YUNIT T1AY XLABEL XTHIRD YTHIRDAPPROX YUNIT T1AY XLABEL XHIGHEST YLABEL T1AY T1AY YLABEL GRFOURTHLEAST	The graph depicts PLOTTITLE . XLABEL XSECOND spent YSECONDAPPROX YUNIT T1AY , XLABEL XFOURTH spent YFOURTHAPPROX YUNIT T1AY , XLABEL XLEAST spent YLEASTAPPROX YUNIT T1AY , XLABEL XHIGHEST spent YHIGHESTAPPROX YUNIT T1AY , and XLABEL XTHIRD spent YTHIRDAPPROX YUNIT T1AY . Overall , XLABEL XHIGHEST spent the most YLABEL on T1AY T1AY , compared to the least amount of YLABEL being spent by XLABEL XFOURTH and XLABEL XLEAST equally .
YLABEL XHIGHEST XLEAST XSECOND	There is a wider YLABEL in the XHIGHEST than XLEAST or XSECOND
YLABEL PLOTTITLE XSECOND YSECOND YUNIT XLABEL T1AY XFOURTH YFOURTH YUNIT XLABEL T1AY XTHIRD YHIGHESTAPPROX YUNIT XLABEL T1AY XLEAST YLEASTAPPROX YUNIT XLABEL T1AY XHIGHEST YHIGHEST YUNIT XLABEL T1AY	This graph depicts the YLABEL of PLOTTITLE . In XSECOND , YSECOND YUNIT of the XLABEL are T1AY , in XFOURTH YFOURTH YUNIT of the XLABEL are T1AY , in XTHIRD YHIGHESTAPPROX YUNIT of the XLABEL are T1AY , in XLEAST YLEASTAPPROX YUNIT of the XLABEL are T1AY , and in XHIGHEST YHIGHEST YUNIT of the XLABEL are T1AY .
PLOTTITLE BARNAMES XHIGHEST YLABEL YHIGHEST YUNIT XSECOND YSECOND YUNIT XTHIRD YTHIRD YUNIT XFOURTH YFOURTH YUNIT XLEAST YLABEL YUNIT	This is a chart showing PLOTTITLE in BARNAMES . XHIGHEST has the most YLABEL , according to this chart , with YHIGHEST YUNIT , closely followed by XSECOND with YSECOND YUNIT , then XTHIRD with YTHIRD YUNIT , then XFOURTH with just YFOURTH YUNIT and XLEAST with the least YLABEL at 24 YUNIT .
PLOTTITLE XLABEL XSTART XHIGHEST XEND XFIFTH YLABEL XLEAST XFIFTH XHIGHEST YHIGHESTAPPROX YUNIT YLABEL XSECOND YSECOND YUNIT YLABEL XTHIRD YTHIRDAPPROX YUNIT XFOURTH YFOURTHAPPROX YUNIT XLEAST YLEASTAPPROX YUNIT XFIFTH YFIFTHAPPROX YUNIT	Here we have a bar chart showing the PLOTTITLE across XLABEL starting XSTART XHIGHEST XEND XFIFTH . The YLABEL seems to have steadily decreased over the XLABEL hitting it 's lowest in XLEAST and increasing slightly by the end of XFIFTH . \\n Between XHIGHESTXEND94 there was just under YHIGHESTAPPROX YUNIT YLABEL . 1995XEND99 XEND a YSECOND YUNIT YLABEL , 2000XEND04 YTHIRDAPPROX YUNIT , 2005XEND09 just under YFOURTHAPPROX YUNIT , XLEASTXEND13 just over YLEASTAPPROX YUNIT and 2015XEND19 around YFIFTHAPPROX YUNIT .
PLOTTITLE XSTART XLABEL XLEAST XEND XHIGHEST XSECOND YSECONDAPPROX YUNIT T1AY GRFOURTHLEAST YLABEL GRYFOURTHLEAST YUNIT T1AY XHIGHEST YLABEL T1AY YHIGHEST YUNIT XTHIRD YTHIRD T1AY	This chart shows the PLOTTITLE varying XSTART XLABEL XLEAST XEND XHIGHEST . \\n \\n From the chart , we can see that those XLABELd XLEAST-24 spend just over YSECONDAPPROX YUNIT on T1AY . Those XLABELd 25-34 and 35-44 spend much less YLABEL with just under GRYFOURTHLEAST YUNIT on T1AY . \\n \\n This increases largely with those between XLABEL 45-54 spending the most YLABEL on T1AY , about XLEAST0 YUNIT . \\n \\n Lastly , this declines largely with those between 55-XHIGHEST who spend about YTHIRD on T1AY .
T1AB T1AY YLABEL YLEAST YMAG XLEAST YTHIRD YMAG XTHIRD YSECOND YMAG XSECOND YHIGHEST YMAG XHIGHEST	T1AB T1AY YLABEL has been tranding upwards , rising from YLEAST YMAG in XLEAST to YTHIRD YMAG in XTHIRD , YSECOND YMAG in XSECOND , to YHIGHEST YMAG in XHIGHEST
YLABEL COUNT T0AX XLABEL T1AB XLEAST XLABEL YLABEL YLEASTAPPROX YUNIT XSECOND YLABEL COUNT XLABEL YSECOND YUNIT YLABEL XHIGHEST YLABEL XSECOND YHIGHEST YUNIT	This chart shows the YLABEL in COUNT different T0AX XLABEL in the T1AB . \\n \\n From this chart , we can see that XLEAST was the XLABEL with the smallest YLABEL of YLEASTAPPROX YUNIT . The XSECOND has the second largest YLABEL of the COUNT XLABEL with a YSECOND YUNIT YLABEL . XHIGHEST YLABEL is the highest , but only slightly higher than the XSECOND at YHIGHEST YUNIT .
PLOTTITLE XLEAST YLEASTAPPROX YMAG YUNIT XSECOND YSECONDAPPROX YMAG YUNIT XTHIRD YTHIRDAPPROX YMAG YUNIT XHIGHEST YHIGHESTAPPROX YMAG YUNIT	The chart shows the PLOTTITLE . \\n \\n XLEAST spent YLEASTAPPROX YMAG YUNIT . XSECOND spent YSECONDAPPROX YMAG YUNIT . XTHIRD YTHIRDAPPROX YMAG YUNIT and XHIGHEST spent the most with YHIGHESTAPPROX YMAG YUNIT .
YLABEL XHIGHEST YUNIT YHIGHESTAPPROX YUNIT YLEASTAPPROX XLEAST GRSECONDTHIRDFOURTH YUNIT GRYSECONDTHIRDFOURTH	YLABEL are highest on XHIGHEST at over YUNIT YHIGHESTAPPROX compared to only YUNIT YLEASTAPPROX on XLEAST . GRSECONDTHIRDFOURTH they level out to an average of YUNIT GRYSECONDTHIRDFOURTH across the week .
PLOTTITLE YLEAST YUNIT T1AX XEND XLEAST YTHIRD YUNIT XTHIRD YSECOND YUNIT XSECOND YHIGHESTAPPROX YUNIT XHIGHEST	This graph shows PLOTTITLE . It shows that YLEAST YUNIT T1AX XEND study XLEAST , YTHIRD YUNIT decide on XTHIRD , YSECOND YUNIT go for XSECOND and YHIGHESTAPPROX YUNIT XHIGHEST .
PLOTTITLE YMAG YUNIT XSECOND YSECONDAPPROX XHIGHEST YHIGHESTAPPROX XTHIRD YTHIRDAPPROX XLEAST YLEAST	the chart shows the PLOTTITLE in YMAG of YUNIT . \\n In XSECOND it was YSECONDAPPROX , in XHIGHEST it was YHIGHESTAPPROX , in XTHIRD it was YTHIRDAPPROX and in XLEAST it was YLEAST
PLOTTITLE XLABEL GRHIGHESTSECOND YLABEL XSECOND YSECONDAPPROX YMAG YUNIT XHIGHEST YHIGHESTAPPROX YMAG YUNIT GRTHIRDLEAST XLEAST YLEASTAPPROX YMAG XTHIRD YLEASTAPPROX	Here we have a bar chart representing PLOTTITLE across various XLABEL . It visually shows GRHIGHESTSECOND having the highest YLABEL over the year with XSECOND spending just over YSECONDAPPROX YMAG YUNIT and XHIGHEST nearly hitting the YHIGHESTAPPROX YMAG YUNIT mark . GRTHIRDLEAST come in last according to this graph , with XLEAST reaching just under YLEASTAPPROX YMAG and XTHIRD just above the YLEASTAPPROX .
PLOTTITLE YLABEL YHIGHESTAPPROX YMAG XHIGHEST YSECONDAPPROX YMAG XSECOND YTHIRDAPPROX YMAG XTHIRD XLABEL YLEASTAPPROX YMAG XLEAST	This chart shows the PLOTTITLE . The largest YLABEL of YHIGHESTAPPROX YMAG are those with a XHIGHEST , followed by YSECONDAPPROX YMAG for those with a XSECOND , YTHIRDAPPROX YMAG for those with a XTHIRD XLABEL and the smallest YLEASTAPPROX YMAG for those with no XLABEL .
XHIGHEST XLABEL YHIGHEST YUNIT T1AY T1AY GRSECONDTHIRD GRYSECONDTHIRD YUNIT T1AB T1AY XLEAST YLEAST YUNIT T1AY T1AB	The table shows that XHIGHEST XLABEL are the most popular , with YHIGHEST YUNIT of T1AY T1AY them . GRSECONDTHIRD are joint 2nd most popular with GRYSECONDTHIRD YUNIT T1AB to T1AY each . XLEAST brings up the rear , with YLEAST YUNIT of T1AY T1AB to T1AY it .
PLOTTITLE XLABEL XHIGHEST YHIGHESTAPPROX YUNIT XSECOND YSECONDAPPROX YUNIT XLABEL COUNT XLEAST YLEASTAPPROX YUNIT	Graph above shows PLOTTITLE . The highest XLABEL was XHIGHEST at YHIGHESTAPPROX YUNIT , XSECOND came in at YSECONDAPPROX YUNIT and the lowest XLABEL out of COUNT was XLEAST at YLEASTAPPROX YUNIT
YLABEL T1AB GRHIGHESTSECOND YSECONDAPPROX YUNIT XSECOND YHIGHESTAPPROX XHIGHEST XHIGHEST YLABEL YHIGHESTAPPROX XHIGHEST YFOURTH XFOURTH XLEAST YUNIT INTERVAL XLABEL YLEASTAPPROX YUNIT	There was an increase in the YLABEL at the T1AB GRHIGHESTSECOND . Increasing from just over YSECONDAPPROX YUNIT in XSECOND to over YHIGHESTAPPROX in XHIGHEST . \\n \\n However from XHIGHEST there has been a slight decline in the YLABEL . From just over YHIGHESTAPPROX in XHIGHEST to YSECONDAPPROX in XFOURTH . \\n \\n XLEAST saw the lowest YLABEL over a INTERVAL XLABEL with just over YLEASTAPPROX YUNIT .
PLOTTITLE YLEAST YUNIT T1AX T1AY XLEAST YTHIRDAPPROX YUNIT T1AX T1AY XTHIRD YSECOND YUNIT XSECOND YSECOND YUNIT T1AX XHIGHEST	Here we see a bar chart showing PLOTTITLE . \\n YLEAST YUNIT T1AX to T1AY XLEAST , Just under YTHIRDAPPROX YUNIT T1AX to T1AY XTHIRD , YSECOND YUNIT XSECOND and just over YSECOND YUNIT T1AX XHIGHEST .
PLOTTITLE YUNIT YTHIRDAPPROX XTHIRD YUNIT YSECOND XSECOND YUNIT YHIGHESTAPPROX XHIGHEST YUNIT YFOURTHAPPROX XFOURTH YUNIT YLEASTAPPROX XLEAST	This graph shows the PLOTTITLE . It shows that it was approximately YUNIT YTHIRDAPPROX on XTHIRD , rising to around YUNIT YSECOND on XSECOND , and rising again to around YUNIT YHIGHESTAPPROX on XHIGHEST . This dipped to YUNIT YFOURTHAPPROX on XFOURTH and decreased again to YUNIT YLEASTAPPROX on XLEAST .
PLOTTITLE YLABEL T1AY XLABEL XHIGHEST YHIGHEST YUNIT YLABEL XLABEL XLEAST YLEASTAPPROX YUNIT T1AY XFOURTH XLABEL	The graph shows PLOTTITLE . The highest YLABEL spent on T1AY was by the XLABEL XHIGHEST at YHIGHEST YUNIT and the lowest YLABEL was by the XLABEL XLEAST with only YLEASTAPPROX YUNIT a T1AY just less than the XFOURTH XLABEL .
YHIGHEST YUNIT T1AY XHIGHEST BARSREST	There are YHIGHEST YUNIT of T1AY in XHIGHEST , which is more than BARSREST .
YLABEL XLABEL T1AB XLABEL XSECOND XEND XFOURTH YLABEL XHIGHEST YHIGHEST YUNIT YLABEL XLEAST YLEAST YUNIT XLABEL	The graph details the YLABEL per XLABEL , at the T1AB . Covering the XLABELs XSECOND XEND XFOURTH the graph shows that the highest YLABEL occurred in XHIGHEST , with YHIGHEST YUNIT . The lowest YLABEL occurred in XLEAST , with YLEAST YUNIT that XLABEL .
T1AY T1AB T0AY XLEAST XLABEL XTHIRD XSECOND XHIGHEST BARSREST XLABEL OTHEROPERATION T1AY XLEAST	T1AY at T1AB were less likely to be T0AY in XLEAST XLABEL than in XTHIRD , XSECOND and XHIGHEST . The BARSREST XLABEL were studied by at least OTHEROPERATION as many T1AY than XLEAST was .
YLABEL XHIGHEST YHIGHESTAPPROX YUNIT XSECOND YSECOND YUNIT XLEAST YLABEL YLEAST YUNIT	This graph shows that the YLABEL is largest in the XHIGHEST at over YHIGHESTAPPROX YUNIT , the next highest is XSECOND at YSECOND YUNIT . XLEAST has the lowest YLABEL at YLEAST YUNIT
PLOTTITLE YTHIRD YUNIT XTHIRD T1AY T1AY YSECONDAPPROX YUNIT XSECOND XHIGHEST YHIGHEST YUNIT XLEAST YLEAST YUNIT	This graph shows the PLOTTITLE . Almost YTHIRD YUNIT of XTHIRD consisted of T1AY , and T1AY make up over YSECONDAPPROX YUNIT of the XSECOND . The XHIGHEST is even higher at YHIGHEST YUNIT , and XLEAST come in the smallest at YLEAST YUNIT .
PLOTTITLE YLEAST YUNIT XLEAST YTHIRD YUNIT XTHIRD YSECOND YUNIT XSECOND YHIGHEST YUNIT XHIGHEST	The chart shows PLOTTITLE . \\n YLEAST YUNIT do XLEAST , YTHIRD YUNIT do XTHIRD , YSECOND YUNIT do XSECOND and YHIGHEST YUNIT do XHIGHEST
XHIGHEST XLABEL T1AY T1AY YHIGHEST YUNIT XLABEL BARSREST	XHIGHEST is the most popular XLABEL for T1AY to T1AY and account for YHIGHEST YUNIT of XLABEL . BARSREST are significantly lower .
PLOTTITLE YLABEL XLEAST YLEAST YUNIT YLABEL XHIGHEST YHIGHEST YUNIT XSECOND YSECOND YUNIT YLABEL XTHIRD YTHIRD YUNIT	Graph above shows PLOTTITLE . The lowest YLABEL recorded was for XLEAST at YLEAST YUNIT , the highest YLABEL was recorded for XHIGHEST at YHIGHEST YUNIT . The second highest was for XSECOND at YSECOND YUNIT . The second lowest YLABEL was for XTHIRD at YTHIRD YUNIT .
PLOTTITLE YLABEL YHIGHEST YUNIT XHIGHEST XSECOND YSECOND YUNIT YTHIRD YUNIT XTHIRD YFOURTH YUNIT XFOURTH	The graph shows PLOTTITLE . The highest YLABEL is YHIGHEST YUNIT in XHIGHEST . This is followed by the XSECOND at YSECOND YUNIT . YTHIRD YUNIT is for XTHIRD and then lastly at YFOURTH YUNIT , XFOURTH .
PLOTTITLE YLEAST YUNIT XLEAST YSECOND YUNIT T1AX XSECOND YHIGHEST YUNIT XHIGHEST YTHIRD YUNIT XTHIRD T1AX	This chart represents PLOTTITLE . \\n Around YLEAST YUNIT XLEAST . \\n YSECOND YUNIT spend their T1AX XSECOND . \\n YHIGHEST YUNIT XHIGHEST and YTHIRD YUNIT XTHIRD in the T1AX .
PLOTTITLE XHIGHEST YHIGHEST YUNIT YLABEL XSECOND YSECOND YUNIT XTHIRD YTHIRDAPPROX YUNIT XLEAST YLEAST YUNIT	This graph shows the PLOTTITLE . XHIGHEST have YHIGHEST YUNIT YLABEL followed by XSECOND with YSECOND YUNIT , XTHIRD with YTHIRDAPPROX YUNIT and XLEAST with YLEAST YUNIT .
YLABEL PLOTTITLE XHIGHEST XSECOND XTHIRD XLEAST	The graph shows the YLABEL of PLOTTITLE . The largest is in XHIGHEST , followed by the XSECOND , then XTHIRD and lastly XLEAST .
PLOTTITLE XLEAST XLABEL YLEASTAPPROX YUNIT XSECOND YSECONDAPPROX YUNIT XHIGHEST XLABEL YHIGHESTAPPROX YUNIT	Bar chart showing the PLOTTITLE . \\n \\n XLEAST is the lowest XLABEL at YLEASTAPPROX YUNIT , then XSECOND at YSECONDAPPROX YUNIT , with XHIGHEST as the main XLABEL at YHIGHESTAPPROX YUNIT .
XHIGHEST YLABEL T1AB YUNIT YHIGHESTAPPROX XSECOND YUNIT YSECONDAPPROX XTHIRD YUNIT YTHIRDAPPROX XFOURTH YUNIT YFOURTHAPPROX XLEAST YUNIT YLEASTAPPROX	On XHIGHEST the YLABEL for T1AB was YUNIT YHIGHESTAPPROX , on XSECOND it was YUNIT YSECONDAPPROX , on XTHIRD YUNIT YTHIRDAPPROX , XFOURTH YUNIT YFOURTHAPPROX and on XLEAST it closed at YUNIT YLEASTAPPROX .
PLOTTITLE XHIGHEST YUNIT YHIGHESTAPPROX XLEAST YUNIT YLEASTAPPROX	This chart shows the PLOTTITLE . \\n They were highest on XHIGHEST at YUNIT YHIGHESTAPPROX . \\n They subsequently fell , ending on XLEAST at around YUNIT YLEASTAPPROX .
PLOTTITLE YHIGHEST YUNIT XHIGHEST YSECOND XSECOND YLEAST YUNIT YLABEL XLEAST	This is a graph showing PLOTTITLE . It shows YHIGHEST YUNIT of it ' s caused by XHIGHEST , a YSECOND of it is due to XSECOND , and just under YLEAST YUNIT of YLABEL is due to XLEAST .
PLOTTITLE YUNIT XHIGHEST YLABEL YUNIT YHIGHESTAPPROX YUNIT YSECONDAPPROX XSECOND XTHIRD YUNIT YTHIRDAPPROX YUNIT YFOURTHAPPROX XFOURTH XLEAST YLABEL YUNIT YLEASTAPPROX	The graph shows the PLOTTITLE , in YUNIT . On XHIGHEST , YLABEL were at their highest , at YUNIT YHIGHESTAPPROX , falling to YUNIT YSECONDAPPROX on XSECOND . There was a smaller decrease on XTHIRD to YUNIT YTHIRDAPPROX , and a marginal decrease to YUNIT YFOURTHAPPROX on XFOURTH . By XLEAST , closing YLABEL had fallen to YUNIT YLEASTAPPROX .
T1AY YLABEL T1AB XLABEL XHIGHEST YUNIT YHIGHESTAPPROX YMAG YUNIT ADDHIGHESTSECOND YMAG T1AY XSECOND XLABEL YUNIT ADDSECONDTHIRD YMAG T1AY XTHIRD XLABEL XLEAST YUNIT YLEAST YMAG T1AY	This graph shows that the T1AY YLABEL a T1AB increases as the level of their XLABEL rises . Those with a XHIGHEST earn over YUNIT YHIGHESTAPPROX YMAG , about YUNIT ADDHIGHESTSECOND YMAG T1AY more than those with a XSECOND XLABEL , who in turn earn about YUNIT ADDHIGHESTSECOND YMAG T1AY more than those with a XTHIRD XLABEL . Those with no XLABEL earn the least at about YUNIT YLEAST YMAG T1AY .
T1AY YLABEL T1AB XLABEL XHIGHEST YLABEL YUNIT YHIGHESTAPPROX YMAG XSECOND YUNIT YSECOND YMAG XTHIRD YUNIT YTHIRDAPPROX YMAG XLEAST YUNIT YLEAST YMAG T1AY YLABEL	chart shows T1AY YLABEL of T1AB per XLABEL showing in XHIGHEST YLABEL was over YUNIT YHIGHESTAPPROX YMAG , followed by XSECOND with YUNIT YSECOND YMAG , XTHIRD with YUNIT YTHIRDAPPROX YMAG and XLEAST YUNIT YLEAST YMAG . as a rebut the graph shows an increase in T1AY YLABEL as time goes on
PLOTTITLE GRHIGHESTSECOND XLABEL GRYHIGHESTSECOND YUNIT T1AY T1AX T1AY GRHIGHESTSECOND YLEAST YUNIT T1AY T1AX XLEAST	This chart represents the PLOTTITLE . \\n \\n GRHIGHESTSECOND are the most popular XLABEL , with just over GRYHIGHESTSECOND YUNIT of the T1AY T1AX to T1AY in one of GRHIGHESTSECOND . \\n \\n Only YLEAST YUNIT of T1AY T1AX to T1AY STEM XLABEL .
PLOTTITLE XLABEL XHIGHEST XSECOND XTHIRD XLEAST YLABEL	This chart shows PLOTTITLE in various XLABEL . We can see that XHIGHEST spends the most by far , followed by XSECOND . XTHIRD and XLEAST trail behind with much smaller YLABEL .
