PLOTTITLE YUNIT BARNAMES XHIGHEST YLABEL YHIGHESTAPPROX YUNIT YLABEL XLEAST YLABEL YLEAST YUNIT YLABEL T0AY	 This chart shows the PLOTTITLE , by YUNIT between BARNAMES . The XHIGHEST has the largest YLABEL with over YHIGHESTAPPROX YUNIT YLABEL . XLEAST has the smallest YLABEL with only YLEAST YUNIT YLABEL T0AY .
PLOTTITLE COUNT T0AX XLABEL YLABEL XLEAST YLEAST YUNIT XSECOND YSECOND YUNIT XHIGHEST YLABEL YHIGHEST YUNIT	 this chart shows the PLOTTITLE across COUNT T0AX XLABEL , the lowest YLABEL being XLEAST with YLEAST YUNIT , XSECOND with YSECOND YUNIT and the XHIGHEST having the biggest YLABEL with YHIGHEST YUNIT
PLOTTITLE COUNT XLABEL XHIGHEST YUNIT YLABEL YHIGHESTAPPROX YUNIT XSECOND YSECOND YUNIT XLEAST YLEAST YUNIT	 This chart displays the PLOTTITLE in COUNT XLABEL . The XHIGHEST has the highest YUNIT of a YLABEL with YHIGHESTAPPROX YUNIT , followed by XSECOND at YSECOND YUNIT and lastly XLEAST with YLEAST YUNIT .
PLOTTITLE BARNAMES XHIGHEST YLABEL YHIGHEST YUNIT YLEASTAPPROX YUNIT XLEAST YSECONDAPPROX YUNIT XSECOND	 This chart looks at the PLOTTITLE in BARNAMES . In XHIGHEST the YLABEL was rated at YHIGHEST YUNIT , YLEASTAPPROX YUNIT in XLEAST and YSECONDAPPROX YUNIT in the XSECOND .
YLABEL COUNT XLABEL YUNIT T1AB XHIGHEST YHIGHEST YUNIT YLABEL XSECOND YLABEL YSECONDAPPROX YUNIT YLABEL XLEAST YLEASTAPPROX YUNIT	 The graph depicts the YLABEL in COUNT XLABEL displayed as a YUNIT , for the T1AB . In XHIGHEST , there was a YHIGHEST YUNIT YLABEL , similar to the XSECOND YLABEL which was just over YSECONDAPPROX YUNIT . The YLABEL was smallest in XLEAST , at YLEASTAPPROX YUNIT .
YLABEL T0AX XLABEL YLABEL T0AY XHIGHEST YHIGHESTAPPROX YUNIT YLABEL XSECOND YSECOND YUNIT XLEAST YLABEL YHIGHEST YUNIT	 This graph represents how the YLABEL varies across several T0AX XLABEL . Currently , the largest YLABEL between T0AY is in the XHIGHEST with approximately YHIGHESTAPPROX YUNIT . Secondly , the YLABEL which is the largest is in XSECOND at just under YSECOND YUNIT . Finally XLEAST has the smallest YLABEL with approximately YHIGHEST YUNIT .
XHIGHEST YLABEL YHIGHEST YUNIT XSECOND YSECOND YUNIT XLEAST YLEAST YUNIT	 XHIGHEST has the largest YLABEL at YHIGHEST YUNIT whilst XSECOND is YSECOND YUNIT and XLEAST only YLEAST YUNIT
YLABEL XHIGHEST YHIGHESTAPPROX YUNIT XSECOND YSECOND YUNIT XLEAST YLABEL YLEAST YUNIT	 This graph shows that the YLABEL is largest in the XHIGHEST at over YHIGHESTAPPROX YUNIT , the next highest is XSECOND at YSECOND YUNIT . XLEAST has the lowest YLABEL at YLEAST YUNIT
YLABEL XHIGHEST T1AB YHIGHEST YUNIT XLEAST YLEASTAPPROX YUNIT XSECOND YSECONDAPPROX YUNIT	 The YLABEL in XHIGHEST in T1AB was YHIGHEST YUNIT . In XLEAST it was YLEASTAPPROX YUNIT and in the XSECOND it was slightly more than YSECONDAPPROX YUNIT .
PLOTTITLE COUNT XLABEL XHIGHEST YHIGHESTAPPROX YUNIT XSECOND YSECOND YUNIT XLEAST YLEASTAPPROX YUNIT	 This chart shows the PLOTTITLE of COUNT XLABEL . The largest is the XHIGHEST with YHIGHESTAPPROX YUNIT , followed by XSECOND at YSECOND YUNIT and lastly XLEAST at YLEASTAPPROX YUNIT
YLABEL XLEAST XEND XSECOND XHIGHEST XHIGHEST YLABEL YHIGHEST YUNIT XSECOND YSECOND YUNIT XLEAST YLEASTAPPROX YUNIT	 The YLABEL is less pronounced in XLEAST when compared XEND the XSECOND and XHIGHEST . XHIGHEST shows a YLABEL of YHIGHEST YUNIT , the XSECOND YSECOND YUNIT , and XLEAST is at YLEASTAPPROX YUNIT .
XLEAST YLABEL YLEAST YUNIT XSECOND MULSECONDLEAST YSECOND YUNIT XHIGHEST YLABEL YHIGHEST YUNIT	 XLEAST has the lowest YLABEL of just YLEAST YUNIT . XSECOND is MULSECONDLEAST that at YSECOND YUNIT and the XHIGHEST is behind with the largest YLABEL of YHIGHEST YUNIT .
PLOTTITLE COUNT T0AX XLABEL BARNAMES T1AB YLABEL GRHIGHESTSECOND GRYHIGHESTSECOND YUNIT XLEAST YLEASTAPPROX YUNIT	 The chart shows the PLOTTITLE in COUNT T0AX XLABEL - BARNAMES . \\n In that T1AB the YLABEL is similar in GRHIGHESTSECOND at just over GRYHIGHESTSECOND YUNIT . In XLEAST it stands at YLEASTAPPROX YUNIT .
PLOTTITLE BARNAMES XHIGHEST YLABEL XSECOND XLEAST	 This chart shows the PLOTTITLE between BARNAMES . We can see that the XHIGHEST has the biggest YLABEL , followed by XSECOND and XLEAST has the smallest .
YLABEL XHIGHEST XLEAST XSECOND MULHIGHESTSECOND XSECOND YSECOND YUNIT MULHIGHESTLEAST XLEAST	 The YLABEL is much higher in the XHIGHEST than in XLEAST and XSECOND . It is MULHIGHESTSECOND higher than that in XSECOND which is YSECOND YUNIT and MULHIGHESTLEAST that in XLEAST .
XHIGHEST YLABEL MULHIGHESTLEAST XLEAST	 The XHIGHEST has the highest YLABEL which is more than MULHIGHESTLEAST the lowest of XLEAST
YLABEL T0AY COUNT XLABEL YLEAST YUNIT XLEAST YSECOND YUNIT XSECOND YHIGHEST YUNIT XHIGHEST	 It is the YLABEL T0AY in COUNT different XLABEL . YLEAST YUNIT for XLEAST \\n YSECOND YUNIT for XSECOND \\n YHIGHEST YUNIT for The XHIGHEST
YLABEL XHIGHEST YLABEL YHIGHESTAPPROX XSECOND YLABEL YSECOND YUNIT XLEAST COUNT YLABEL YLEAST YUNIT	 This chart shows that the biggest YLABEL is in the XHIGHEST with a YLABEL of over YHIGHESTAPPROX . XSECOND has a YLABEL of YSECOND YUNIT and XLEAST is the lowest of the COUNT with a YLABEL of YLEAST YUNIT
YLABEL BARNAMES T1AB XHIGHEST YLABEL YHIGHESTAPPROX YUNIT XLEAST YLEASTAPPROX YUNIT	 The YLABEL was investigated in BARNAMES in T1AB . it was found that XHIGHEST had the highest YLABEL at YHIGHESTAPPROX YUNIT and XLEAST the lowest at YLEASTAPPROX YUNIT .
YLABEL COUNT XLABEL YLABEL XHIGHEST YHIGHEST YUNIT XSECOND YSECONDAPPROX YUNIT XLEAST YLEASTAPPROX YUNIT	 This graph shows the YLABEL in COUNT different XLABEL . \\n The YLABEL was largest in XHIGHEST at YHIGHEST YUNIT , the XSECOND next at just over YSECONDAPPROX YUNIT and XLEAST the lowest at YLEASTAPPROX YUNIT .
YLABEL PLOTTITLE BARNAMES XHIGHEST YLABEL XLEAST	 This chat looks at the YLABEL PLOTTITLE in BARNAMES . The XHIGHEST has the largest YLABEL with XLEAST having the lowest .
YLABEL XHIGHEST YHIGHEST YUNIT YLEASTAPPROX YUNIT XLEAST XSECOND YSECONDAPPROX YUNIT	 The YLABEL is highest in XHIGHEST at over YHIGHEST YUNIT compared to YLEASTAPPROX YUNIT in XLEAST and just slightly more than the XSECOND at YSECONDAPPROX YUNIT . \\n Lots of factors come into play here but it is clear from this graph that Germany & the UK needs to step up to close the gender pay gap .
YLABEL COUNT XLABEL BARNAMES T1AB YLABEL XLEAST YLEASTAPPROX YUNIT XSECOND YSECOND YUNIT XHIGHEST YLABEL YHIGHEST YUNIT	 This chart shows the YLABEL in COUNT XLABEL of BARNAMES in the T1AB . From the chart , we see the smallest YLABEL was from XLEAST with YLEASTAPPROX YUNIT , which was followed by the XSECOND at around YSECOND YUNIT . XHIGHEST had the highest YLABEL at around YHIGHEST YUNIT .
PLOTTITLE XLABEL BARNAMES XHIGHEST YLABEL YHIGHEST YUNIT XSECOND YSECONDAPPROX YUNIT XLEAST YLABEL T1AB YLEASTAPPROX YUNIT	 This chart shows the PLOTTITLE in the XLABEL BARNAMES . It shows that XHIGHEST had the biggest YLABEL at YHIGHEST YUNIT , closely followed by the XSECOND at YSECONDAPPROX YUNIT . And XLEAST had the least YLABEL in T1AB at YLEASTAPPROX YUNIT .
PLOTTITLE YUNIT BARNAMES XHIGHEST YLABEL XSECOND XLEAST YLABEL	 The graph indicates the PLOTTITLE as a YUNIT , comparing the BARNAMES . The XHIGHEST has the largest YLABEL , followed by XSECOND and then XLEAST has the smallest YLABEL .
XHIGHEST YLABEL YHIGHEST YUNIT XSECOND YSECONDAPPROX YUNIT XLEAST YLEASTAPPROX YUNIT	 XHIGHEST has the highest YLABEL at YHIGHEST YUNIT , followed by the XSECOND at YSECONDAPPROX YUNIT and XLEAST at YLEASTAPPROX YUNIT .
YLABEL COUNT T0AX XLABEL BARNAMES YLABEL YUNIT GRHIGHESTSECOND YHIGHEST YSECOND XLEAST YLABEL YLEASTAPPROX YUNIT	 The graph details the YLABEL in COUNT T0AX XLABEL , BARNAMES . Presenting the YLABEL as a YUNIT , the graph shows that GRHIGHESTSECOND have similar levels ( YHIGHEST and YSECOND respectively ) while XLEAST has a smaller YLABEL of YLEASTAPPROX YUNIT .
PLOTTITLE COUNT XLABEL BARNAMES YLABEL XHIGHEST YHIGHESTAPPROX YUNIT XLEAST YLEAST YUNIT	 This chart depicts the PLOTTITLE in COUNT different XLABEL : BARNAMES . The chart shows that the YLABEL is largest in the XHIGHEST at over YHIGHESTAPPROX YUNIT , and smallest in XLEAST at YLEAST YUNIT .
T1AB YLABEL GRHIGHESTSECOND GRYHIGHESTSECOND YUNIT YLEASTAPPROX YUNIT XLEAST YLABEL	 In T1AB the YLABEL can be identified in GRHIGHESTSECOND as representing GRYHIGHESTSECOND YUNIT overall . Although lower at YLEASTAPPROX YUNIT , XLEAST still has an identifiable YLABEL which should be acknowledged .
PLOTTITLE XHIGHEST YLABEL YHIGHEST YUNIT XSECOND ADDSECONDHIGHEST YUNIT YSECOND YUNIT XLEAST YLABEL YLEASTAPPROX YUNIT	 This chart represents the PLOTTITLE . XHIGHEST YLABEL is YHIGHEST YUNIT , whilst the XSECOND settles ADDSECONDHIGHEST YUNIT below at YSECOND YUNIT . Overall XLEAST is seen to have the lowest YLABEL at YLEASTAPPROX YUNIT .
BARNAMES YLABEL XHIGHEST YHIGHEST YUNIT XSECOND XLEAST YLEASTAPPROX YUNIT	 Between BARNAMES the YLABEL is biggest in XHIGHEST at YHIGHEST YUNIT , a little more than in the XSECOND . XLEAST is at YLEASTAPPROX YUNIT .
YLABEL ADDHIGHESTLEAST YUNIT XHIGHEST XLEAST XSECOND OTHEROPERATION	 The YLABEL is greatest by about ADDHIGHESTLEAST YUNIT in the XHIGHEST than in XLEAST . XSECOND is exactly OTHEROPERATION between the two countries .
PLOTTITLE COUNT T0AX XLABEL YLABEL XHIGHEST YHIGHEST YUNIT YLABEL XSECOND XLEAST YLABEL YLEASTAPPROX YUNIT YLABEL	 A chart showing the PLOTTITLE in COUNT T0AX XLABEL . the YLABEL is the largest in XHIGHEST with a YHIGHEST YUNIT YLABEL although this is closely followed by the XSECOND . XLEAST has the smallest YLABEL with only a YLEASTAPPROX YUNIT YLABEL .
PLOTTITLE COUNT T0AX XLABEL GRHIGHESTSECOND XHIGHEST XSECOND YLABEL GRYHIGHESTSECOND YUNIT XLEAST YLABEL YLEASTAPPROX YUNIT	 This chart shows the PLOTTITLE from COUNT T0AX XLABEL . The GRHIGHESTSECOND , XHIGHEST and the XSECOND have a similar YLABEL at just above GRYHIGHESTSECOND YUNIT . XLEAST has the lowest YLABEL at YLEASTAPPROX YUNIT .
PLOTTITLE BARNAMES YLABEL YLEAST YUNIT XLEAST YSECOND YUNIT XSECOND YHIGHESTAPPROX YUNIT XHIGHEST	 This graph shows a PLOTTITLE in BARNAMES . the YLABEL is YLEAST YUNIT in XLEAST , YSECOND YUNIT in XSECOND and just over YHIGHESTAPPROX YUNIT in the XHIGHEST .
YLABEL XHIGHEST XLEAST XSECOND	 There is a wider YLABEL in the XHIGHEST than XLEAST or XSECOND
YLABEL COUNT XLABEL YUNIT XHIGHEST YHIGHEST YUNIT XSECOND YSECONDAPPROX YUNIT XLEAST YLEASTAPPROX YUNIT	 YLABEL shown in graph form to show COUNT different XLABEL against YUNIT . XHIGHEST was the highest at YHIGHEST YUNIT , XSECOND came in slightly lower at just over YSECONDAPPROX YUNIT . XLEAST was the lowest at YLEASTAPPROX YUNIT .
