T1AY YLABEL T1AB XSTART XLEAST XEND XHIGHEST T0AY YUNIT SLOPEY YMAG SLOPEX XLABEL	 The T1AY YLABEL for T1AB has risen steadily XSTART XLEAST XEND XHIGHEST , with on T0AY a YUNIT SLOPEY YMAG increase every SLOPEX XLABEL .
T1AY YLABEL T1AB XSTART XLEAST XEND XHIGHEST T1AB YLABEL	 This graph presents the T1AY YLABEL of T1AB XSTART XLEAST XEND XHIGHEST . T1AB YLABEL have been steadily increasing over this time .
YLABEL T1AB	 The YLABEL of T1AB has gone up year on year
T1AY YLABEL T1AB XLABEL XLEAST XLABEL XHIGHEST	 This graph illustrates that the T1AY YLABEL for T1AB has been increasing at a constant rate from the XLABEL XLEAST up to the XLABEL XHIGHEST .
PLOTTITLE XSTART XLABEL XSECOND XEND XLEAST XLABEL XSECOND YUNIT YSECONDAPPROX YMAG YLABEL YUNIT YHIGHESTAPPROX YMAG XHIGHEST INTERVAL XLABEL YUNIT YTHIRDAPPROX YMAG XLABEL XTHIRD YUNIT YLEAST YMAG XLEAST	 This chart represents the PLOTTITLE ranging XSTART the XLABEL XSECOND XEND XLEAST . \\n \\n In the XLABEL XSECOND it started off at YUNIT YSECONDAPPROX YMAG . \\n \\n The highest YLABEL is YUNIT YHIGHESTAPPROX YMAG in the year XHIGHEST . \\n \\n Then it drops in the next INTERVAL XLABEL from YUNIT YTHIRDAPPROX YMAG in XLABEL XTHIRD to YUNIT YLEAST YMAG in XLEAST .
XSTART XLEAST XEND XHIGHEST T1AY YLABEL T1AB YUNIT YLEAST YMAG XLEAST YUNIT YHIGHESTAPPROX YMAG XHIGHEST	 This graph shows that XSTART XLEAST XEND XHIGHEST the T1AY YLABEL of T1AB rose consistently from YUNIT YLEAST YMAG in XLEAST to over YUNIT YHIGHESTAPPROX YMAG in XHIGHEST
T1AY YLABEL T1AB XLABEL XHIGHEST YLABEL YUNIT YHIGHESTAPPROX YMAG XSECOND YUNIT YSECOND YMAG XTHIRD YUNIT YTHIRDAPPROX YMAG XLEAST YUNIT YLEAST YMAG T1AY YLABEL	 chart shows T1AY YLABEL of T1AB per XLABEL showing in XHIGHEST YLABEL was over YUNIT YHIGHESTAPPROX YMAG , followed by XSECOND with YUNIT YSECOND YMAG , XTHIRD with YUNIT YTHIRDAPPROX YMAG and XLEAST YUNIT YLEAST YMAG . as a rebut the graph shows an increase in T1AY YLABEL as time goes on
XHIGHEST T1AB T1AY YLABEL YHIGHESTAPPROX YMAG YSECOND YMAG XSECOND XTHIRD YTHIRD YMAG YLEAST YMAG XLEAST	 XHIGHEST saw T1AB T1AY YLABEL rise to YHIGHESTAPPROX YMAG , from YSECOND YMAG in XSECOND . XTHIRD it was at YTHIRD YMAG from YLEAST YMAG in XLEAST , so you can see it has been rising steadily
PLOTTITLE XSTART XLABEL XLEAST XEND XHIGHEST YLABEL	 This shows the PLOTTITLE XSTART the XLABEL of XLEAST XEND XHIGHEST . We can see that year on year , YLABEL are slowly increasing .
T1AY YLABEL T1AB XLABEL INTERVAL XLABEL INTERVAL XLABEL ADDHIGHESTLEAST YMAG YUNIT	 The T1AY YLABEL of T1AB per XLABEL is gradually and steadily rising every INTERVAL XLABEL . In the last INTERVAL XLABEL it has risen ADDHIGHESTLEAST YMAG YUNIT .
PLOTTITLE XLABEL XSECOND YUNIT YSECONDAPPROX YMAG YUNIT YHIGHESTAPPROX YMAG XHIGHEST YUNIT YTHIRDAPPROX YMAG YUNIT YLEAST YMAG XTHIRD XLEAST	 This chart shows the PLOTTITLE . In the XLABEL XSECOND , this was around YUNIT YSECONDAPPROX YMAG . This then rose to just over YUNIT YHIGHESTAPPROX YMAG in XHIGHEST , before dropping to YUNIT YTHIRDAPPROX YMAG and YUNIT YLEAST YMAG in XTHIRD and XLEAST respectively .
PLOTTITLE XSTART XLEAST XEND XHIGHEST	 This chart shows the PLOTTITLE . It shows that there has been quite a small increase XSTART XLEAST XEND XHIGHEST .
PLOTTITLE YMAG YUNIT INTERVAL XLABEL XSTART XLABEL XLEAST XEND XHIGHEST	 This graph shows the PLOTTITLE in YMAG of YUNIT every INTERVAL XLABEL XSTART the XLABEL XLEAST XEND XHIGHEST .
PLOTTITLE XSECOND YLABEL YUNIT YSECONDAPPROX YMAG XHIGHEST YUNIT YHIGHESTAPPROX YMAG XTHIRD YLABEL YUNIT YTHIRDAPPROX YMAG XLEAST YUNIT YLEAST YMAG	 The chart shows the PLOTTITLE . \\n In XSECOND the YLABEL was YUNIT YSECONDAPPROX YMAG . In XHIGHEST this increased to YUNIT YHIGHESTAPPROX YMAG . In XTHIRD the YLABEL fell to YUNIT YTHIRDAPPROX YMAG and in XLEAST it was the lowest at YUNIT YLEAST YMAG
PLOTTITLE XSECOND YSECONDAPPROX YMAG YUNIT YHIGHESTAPPROX YMAG XHIGHEST YTHIRDAPPROX YMAG XTHIRD XEND YLEAST YMAG XLEAST	 This chart shows the PLOTTITLE . In XSECOND it was YSECONDAPPROX YMAG YUNIT , rising to YHIGHESTAPPROX YMAG in XHIGHEST then dropping to YTHIRDAPPROX YMAG in XTHIRD and lowering again XEND YLEAST YMAG in XLEAST
PLOTTITLE XLEAST SLOPEY YUNIT	 The PLOTTITLE has grown since XLEAST by at least SLOPEY YUNIT
PLOTTITLE SLOPEY YMAG SLOPEX XLABEL	 The PLOTTITLE appears to increase by SLOPEY YMAG SLOPEX XLABEL .
PLOTTITLE XSECOND YUNIT YSECONDAPPROX YMAG YLABEL XHIGHEST YUNIT YHIGHESTAPPROX YMAG XTHIRD YUNIT YTHIRDAPPROX YMAG XLEAST YLABEL XLEAST YUNIT YLEAST YMAG	 This chart shows the PLOTTITLE . \\n \\n In XSECOND , YUNIT YSECONDAPPROX YMAG was the YLABEL , which increased by XHIGHEST to just under YUNIT YHIGHESTAPPROX YMAG . This had dropped by XTHIRD however , at YUNIT YTHIRDAPPROX YMAG - and dropped again in XLEAST . The YLABEL XLEAST dropped to YUNIT YLEAST YMAG .
PLOTTITLE YUNIT YSECONDAPPROX YMAG XSECOND XHIGHEST YHIGHESTAPPROX YMAG XHIGHEST T1AX YLABEL T1AB YUNIT YTHIRDAPPROX YMAG XTHIRD YLEAST YMAG XLEAST	 As you can see this is a graph of the PLOTTITLE . You can see that this graph fluctuates starting with around YUNIT YSECONDAPPROX YMAG in XSECOND which rose XHIGHEST to just over YHIGHESTAPPROX YMAG in XHIGHEST . After this you can see that the T1AX YLABEL for T1AB has dropped to just under YUNIT YTHIRDAPPROX YMAG in XTHIRD and dropped again to approx. YLEAST YMAG in XLEAST .
PLOTTITLE INTERVAL XLABEL XSTART XLEAST XEND XHIGHEST XLEAST YLABEL YLEAST YMAG XTHIRD YTHIRDAPPROX YMAG XSECOND YSECOND YMAG XHIGHEST YHIGHESTAPPROX YMAG	 Chart shows the PLOTTITLE every INTERVAL XLABEL XSTART XLEAST XEND XHIGHEST . The charts shows it has steadily increased . In XLEAST the YLABEL was YLEAST YMAG , XTHIRD it was YTHIRDAPPROX YMAG , XSECOND was YSECOND YMAG and finally in XHIGHEST it was YHIGHESTAPPROX YMAG
PLOTTITLE XSTART XSECOND XEND XLEAST YLABEL XHIGHEST YUNIT YHIGHESTAPPROX YMAG XHIGHEST YUNIT YTHIRDAPPROX YMAG XTHIRD YUNIT YLEAST YMAG XLEAST	 The graph shows the PLOTTITLE XSTART XSECOND XEND XLEAST . The YLABEL was highest in XHIGHEST with YUNIT YHIGHESTAPPROX YMAG . Since XHIGHEST it has dropped , staying at YUNIT YTHIRDAPPROX YMAG in XTHIRD and then YUNIT YLEAST YMAG in XLEAST .
PLOTTITLE XSTART XLABEL XSECOND XEND XLEAST XLABEL XSECOND YSECONDAPPROX YMAG YHIGHESTAPPROX YMAG XHIGHEST XTHIRD YTHIRDAPPROX YMAG XLEAST	 Here is a chart based on PLOTTITLE XSTART the XLABEL of XSECOND XEND XLEAST . \\n In the XLABEL XSECOND it was holding at YSECONDAPPROX YMAG , rising to just over YHIGHESTAPPROX YMAG in XHIGHEST . From XTHIRD it dropped dramatically to under YTHIRDAPPROX YMAG and again in XLEAST .
PLOTTITLE INTERVAL XLABEL XLABEL XSECOND XHIGHEST YUNIT YHIGHESTAPPROX YMAG YLABEL YUNIT YLEAST YMAG XLEAST	 The PLOTTITLE per INTERVAL XLABEL started fairly high in the table in the XLABEL XSECOND and showed its highest in XHIGHEST being YUNIT YHIGHESTAPPROX YMAG . Over the next 10 years the YLABEL soon dropped to a shocking YUNIT YLEAST YMAG by XLEAST .
PLOTTITLE XSTART XSECOND XEND XLEAST YUNIT GRHIGHESTSECOND YLABEL T1AB YUNIT ADDLEASTHIGHEST YMAG XLABEL XLEAST XHIGHEST	 This chart shows the PLOTTITLE , XSTART XSECOND XEND XLEAST , in YUNIT . It shows that there was a slight initial increase GRHIGHESTSECOND , but since then , YLABEL have been declining and T1AB were earning almost YUNIT ADDLEASTHIGHEST YMAG less per XLABEL in XLEAST than they were a XHIGHEST .
PLOTTITLE INTERVAL XLABEL XSECOND YLABEL YUNIT YSECONDAPPROX YMAG XHIGHEST YLABEL YUNIT YHIGHESTAPPROX YMAG XTHIRD YLABEL YUNIT YTHIRDAPPROX YMAG XLEAST YLABEL YUNIT YLEAST YMAG	 The bar chart shows the PLOTTITLE over a INTERVAL XLABEL period . In XSECOND the YLABEL was approximately YUNIT YSECONDAPPROX YMAG . In XHIGHEST the YLABEL was just under YUNIT YHIGHESTAPPROX YMAG . In XTHIRD the YLABEL was just under YUNIT YTHIRDAPPROX YMAG whilst in XLEAST the YLABEL was roughly YUNIT YLEAST YMAG .
PLOTTITLE XSECOND YLABEL YSECONDAPPROX YMAG XHIGHEST YLABEL MULHIGHESTSECOND YUNIT XLEAST XHIGHEST XEND XLEAST XSTART XHIGHEST XEND XTHIRD MULTHIRDHIGHEST YUNIT YLABEL MULLEASTTHIRD YUNIT XEND XLEAST	 The chart shows the PLOTTITLE . In XSECOND the YLABEL was approximately YSECONDAPPROX YMAG . XHIGHEST there was a healthy increase to the YLABEL of MULHIGHESTSECOND YUNIT however XLEAST ( XHIGHEST XEND XLEAST ) this decreased . XSTART XHIGHEST XEND XTHIRD there was a MULTHIRDHIGHEST YUNIT decrease in YLABEL and a further MULLEASTTHIRD YUNIT decrease XEND XLEAST .
T1AY YLABEL T1AB XLEAST T0AY YLABEL T1AB YHIGHESTAPPROX YMAG YUNIT XHIGHEST YLEAST YMAG XLEAST	 This chart shows that the T1AY YLABEL for T1AB has increased continualy since XLEAST , with the T0AY YLABEL for T1AB over YHIGHESTAPPROX YMAG YUNIT in XHIGHEST , compared to YLEAST YMAG in XLEAST .
YLABEL YUNIT YLEAST YMAG YUNIT YHIGHESTAPPROX YMAG XSTART XSECOND XEND XLEAST YLABEL XHIGHEST XLEAST	 The YLABEL fluctuated between YUNIT YLEAST YMAG to YUNIT YHIGHESTAPPROX YMAG XSTART XSECOND XEND XLEAST , with the highest YLABEL being XHIGHEST and the lowest being XLEAST .
PLOTTITLE XSTART XLABEL XLEAST XEND XHIGHEST YLABEL XHIGHEST YHIGHEST YMAG YSECOND YMAG XSECOND XTHIRD YLABEL YTHIRD YMAG XLEAST YLEAST YMAG SLOPEX XLABEL SLOPEY YMAG	 This graph represents the PLOTTITLE XSTART the XLABEL XLEAST XEND XHIGHEST . The highest YLABEL is in XHIGHEST with YHIGHEST YMAG , this is above the YSECOND YMAG in XSECOND . In XTHIRD the YLABEL was YTHIRD YMAG and in XLEAST YLEAST YMAG . This shows an increase every SLOPEX XLABEL of SLOPEY YMAG .
T1AB T1AY YLABEL YLEAST YMAG XLEAST YTHIRD YMAG XTHIRD YSECOND YMAG XSECOND YHIGHEST YMAG XHIGHEST	 T1AB T1AY YLABEL has been tranding upwards , rising from YLEAST YMAG in XLEAST to YTHIRD YMAG in XTHIRD , YSECOND YMAG in XSECOND , to YHIGHEST YMAG in XHIGHEST
PLOTTITLE XSTART XLABEL XLEAST XEND XHIGHEST XLABEL T1AY YLABEL YLEAST YMAG XLEAST YHIGHESTAPPROX YMAG XHIGHEST	 This chart shows the PLOTTITLE XSTART the XLABEL XLEAST XEND XHIGHEST . Over the XLABEL the T1AY YLABEL has increased it was YLEAST YMAG in XLEAST and is now YHIGHESTAPPROX YMAG in XHIGHEST .
PLOTTITLE COUNT XLABEL BARNAMES YLABEL YUNIT YSECONDAPPROX YMAG XSECOND YUNIT YHIGHESTAPPROX YMAG XHIGHEST XEND YUNIT YTHIRDAPPROX YMAG XTHIRD XLEAST XEND YUNIT YLEAST YMAG	 This graph shows the PLOTTITLE over COUNT XLABEL , BARNAMES . YLABEL increased from YUNIT YSECONDAPPROX YMAG in XSECOND to YUNIT YHIGHESTAPPROX YMAG in XHIGHEST but have fallen since XEND just under YUNIT YTHIRDAPPROX YMAG in XTHIRD falling further in XLEAST XEND YUNIT YLEAST YMAG .
T1AY YLABEL T1AB INTERVAL XSTART XLABEL XLEAST XEND XHIGHEST YUNIT YLEAST YMAG XLEAST YUNIT YTHIRDAPPROX YMAG XTHIRD YUNIT YSECOND YMAG XSECOND YUNIT YHIGHESTAPPROX YMAG XHIGHEST	 This graph shows how the T1AY YLABEL of T1AB has changed over time . This is done by looking every INTERVAL XSTART the XLABEL XLEAST XEND XHIGHEST . YUNIT YLEAST YMAG - XLEAST \\n YUNIT YTHIRDAPPROX YMAG - XTHIRD \\n YUNIT YSECOND YMAG - XSECOND \\n YUNIT YHIGHESTAPPROX YMAG - XHIGHEST
PLOTTITLE XSECOND YUNIT YSECONDAPPROX YUNIT XLABEL XHIGHEST YUNIT YHIGHESTAPPROX YUNIT XLABEL XTHIRD YUNIT YTHIRDAPPROX YUNIT XLABEL XLEAST YUNIT YLEASTAPPROX YUNIT XLABEL	 Here we see a bar chart of PLOTTITLE . \\n In XSECOND it was just under YUNIT YSECONDAPPROX YUNIT a XLABEL . \\n In XHIGHEST it was just above YUNIT YHIGHESTAPPROX YUNIT a XLABEL . \\n In XTHIRD it was just under YUNIT YTHIRDAPPROX YUNIT a XLABEL . \\n In XLEAST it was just above YUNIT YLEASTAPPROX YUNIT a XLABEL . \\n It is unclear according to this chart why the median has n't been consistent .
PLOTTITLE YUNIT YLABEL T1AB T1AB YUNIT YLEASTAPPROX YMAG XLEAST XHIGHEST YUNIT YHIGHESTAPPROX YMAG	 This chart shows the PLOTTITLE in YUNIT . \\n From the chart we can see that the median YLABEL of T1AB in T1AB is the lowest at approximately YUNIT YLEASTAPPROX YMAG in XLEAST . The highest is XHIGHEST at YUNIT YHIGHESTAPPROX YMAG
SLOPEX XLABEL T1AY YLABEL T1AB SLOPEY YUNIT SLOPEX	 The chart shows every SLOPEX XLABEL the T1AY YLABEL of T1AB is rising by about SLOPEY YUNIT a SLOPEX .
YLABEL XLABEL T1AB T1AB YLABEL XHIGHEST YUNIT YHIGHESTAPPROX YMAG YUNIT YSECONDAPPROX YMAG XLABEL XSECOND XHIGHEST YUNIT YTHIRDAPPROX YMAG XLABEL XTHIRD YUNIT YLEAST YMAG XLEAST	 The YLABEL per XLABEL of T1AB in T1AB has been changing with the years , the highest YLABEL was on XHIGHEST , being this YUNIT YHIGHESTAPPROX YMAG , which was good sign of growing since it was around YUNIT YSECONDAPPROX YMAG in the XLABEL XSECOND . Unfortunately instead of growing after XHIGHEST , it actually decreased to nearly YUNIT YTHIRDAPPROX YMAG by the XLABEL XTHIRD and it continued decreasing to YUNIT YLEAST YMAG for the year XLEAST . If this trend is to continue there were be a decrease in the following years .
