YLABEL XHIGHEST YHIGHEST YUNIT XSECOND YSECOND YUNIT YLABEL XTHIRD YTHIRD YUNIT XFOURTH YFOURTH YUNIT XLEAST YLEAST YUNIT	 Women are represented in their highest YLABEL in XHIGHEST ( YHIGHEST YUNIT of students ) and the XSECOND ( YSECOND YUNIT of students ) . Their YLABEL is much lower in XTHIRD ( YTHIRD YUNIT ) , XFOURTH ( YFOURTH YUNIT ) and XLEAST ( just YLEAST YUNIT ) .
GRHIGHESTSECOND YLABEL GRTHIRDFOURTHLEAST	 This bar chart displays the proportion of women in different university departments . GRHIGHESTSECOND have higher YLABEL , compared to GRTHIRDFOURTHLEAST .
XHIGHEST YLABEL XLABEL YHIGHEST YUNIT XLEAST YLEAST YUNIT XSECOND YSECOND YUNIT XTHIRD XFOURTH YTHIRD YFOURTH YUNIT	 XHIGHEST has the highest YLABEL in XLABEL with YHIGHEST YUNIT however XLEAST has only YLEAST YUNIT , a rather large difference . XSECOND follows closely behind with YSECOND YUNIT but XTHIRD and XFOURTH are even lower again at YTHIRD and YFOURTH YUNIT .
XHIGHEST XLABEL YHIGHEST YUNIT XSECOND YSECOND YUNIT XTHIRD MULTHIRDSECOND XSECOND YTHIRD YUNIT XFOURTH YFOURTH YUNIT MULFOURTHSECOND XSECOND XLEAST YLEAST YUNIT	 The majority of women work in XHIGHEST XLABEL at YHIGHEST YUNIT . Next closest is XSECOND at YSECOND YUNIT . XTHIRD is exactly MULTHIRDSECOND of XSECOND at YTHIRD YUNIT . XFOURTH is YFOURTH YUNIT which is a MULFOURTHSECOND of those in XSECOND , and XLEAST is the least populated at YLEAST YUNIT .
YHIGHEST YUNIT XHIGHEST YSECOND YUNIT XSECOND YTHIRD YUNIT XTHIRD YFOURTH YUNIT XFOURTH YLEAST YUNIT XLEAST	 This graphs shows female representation across university departments . YHIGHEST YUNIT of people in XHIGHEST are female , YSECOND YUNIT in XSECOND are female , YTHIRD YUNIT in XTHIRD , YFOURTH YUNIT in XFOURTH and YLEAST YUNIT in XLEAST .
XHIGHEST XLABEL YHIGHEST YUNIT XSECOND YSECOND YUNIT XTHIRD YTHIRD YUNIT XFOURTH YFOURTH YUNIT XLEAST YLEAST YUNIT	 The table shows women are most well represented in university XHIGHEST XLABEL ( YHIGHEST YUNIT ) , followed by XSECOND ( YSECOND YUNIT ) , XTHIRD ( YTHIRD YUNIT ) , XFOURTH ( YFOURTH YUNIT ) and XLEAST ( YLEAST YUNIT ) .
GRHIGHESTSECOND XLABEL GRFOURTHLEAST	 Women are more likely to work in the GRHIGHESTSECOND in university XLABEL compared to GRFOURTHLEAST
XHIGHEST XLABEL YHIGHEST YUNIT XSECOND YSECOND YUNIT XLEAST YLEAST YUNIT GRTHIRDFOURTH GRYTHIRDFOURTH	 Women are most represented in the XHIGHEST XLABEL at YHIGHEST YUNIT in university , this is closely followed by XSECOND at YSECOND YUNIT . They are least represented in XLEAST at YLEAST YUNIT with GRTHIRDFOURTH GRYTHIRDFOURTH
XHIGHEST XLABEL YLABEL YHIGHEST YUNIT XSECOND XLABEL YSECOND YUNIT YLABEL XTHIRD XLABEL YTHIRD YUNIT XFOURTH YFOURTH YUNIT XLEAST YLEAST YUNIT	 This graph shows percentages of women in different university departments . XHIGHEST XLABEL show the greatest YLABEL at YHIGHEST YUNIT , and XSECOND XLABEL have YSECOND YUNIT . female YLABEL in XTHIRD XLABEL is YTHIRD YUNIT , XFOURTH YFOURTH YUNIT , and XLEAST lowest at YLEAST YUNIT .
YLABEL XLABEL XHIGHEST YHIGHEST YUNIT YSECOND YUNIT XSECOND XTHIRD XFOURTH YLABEL YTHIRD YUNIT YFOURTH YUNIT XLEAST YLABEL YLEAST YUNIT	 The highest YLABEL across XLABEL is in XHIGHEST at YHIGHEST YUNIT , followed closely by YSECOND YUNIT in XSECOND . XTHIRD and XFOURTH have a lower YLABEL at YTHIRD YUNIT and YFOURTH YUNIT respectively . XLEAST has the lowest YLABEL at only YLEAST YUNIT .
YHIGHEST YUNIT XHIGHEST XLABEL YSECOND YUNIT XSECOND YTHIRD YUNIT XTHIRD YFOURTH YUNIT XFOURTH YLEAST YUNIT XLEAST	 This chart demonstrates how many women are in each university department . YHIGHEST YUNIT of people in the XHIGHEST XLABEL are female , compared to YSECOND YUNIT in XSECOND , YTHIRD YUNIT in XTHIRD , YFOURTH YUNIT in XFOURTH and YLEAST YUNIT in XLEAST . This may be because there is less emphasis placed on encouraging women into STEM subjects, and there are and underrepresentation of women in this area .
YLABEL YHIGHEST YUNIT XHIGHEST XSECOND YSECOND YUNIT YTHIRD YUNIT XTHIRD YFOURTH YUNIT XFOURTH	 The graph shows how women are represented within different departments across a university . The highest YLABEL is YHIGHEST YUNIT in XHIGHEST . This is followed by the XSECOND at YSECOND YUNIT . YTHIRD YUNIT is for XTHIRD and then lastly at YFOURTH YUNIT , XFOURTH .
XSECOND XHIGHEST XFOURTH XLEAST XTHIRD	 Women are represented well in the XSECOND and XHIGHEST , but are significantly under-represented in XFOURTH , XLEAST and XTHIRD .
YLABEL XLEAST YLEAST YUNIT XHIGHEST YHIGHEST YUNIT XSECOND YSECOND GRTHIRDFOURTH GRYTHIRDFOURTH	 The chart shows the YLABEL of women in different university departments . In XLEAST , there is only YLEAST YUNIT women , but in XHIGHEST there is YHIGHEST YUNIT . XSECOND also has more than YSECOND women , while GRTHIRDFOURTH have more than GRYTHIRDFOURTH men .
YLABEL XHIGHEST XSECOND XLABEL YLABEL XLEAST YLEAST YUNIT XFOURTH YFOURTH YUNIT XTHIRD YTHIRD YUNIT	 The chart shows how YLABEL is highest in the XHIGHEST and XSECOND XLABEL . The lowest YLABEL are in XLEAST with just YLEAST YUNIT , followed by XFOURTH with YFOURTH YUNIT and XTHIRD with YTHIRD YUNIT
YLABEL YFOURTH YUNIT XFOURTH YSECOND YUNIT XSECOND YLEAST YUNIT XLEAST YHIGHEST YUNIT XHIGHEST YTHIRD YUNIT XTHIRD	 This shows the YLABEL of staff in each university department that are women . \\n \\n YFOURTH YUNIT - XFOURTH \\n YSECOND YUNIT - XSECOND \\n YLEAST YUNIT - XLEAST \\n YHIGHEST YUNIT - XHIGHEST \\n YTHIRD YUNIT - XTHIRD
XLABEL YHIGHEST YUNIT XHIGHEST XLABEL XSECOND YSECOND YUNIT XTHIRD YTHIRD YUNIT XFOURTH YFOURTH YUNIT XLEAST YLEAST YUNIT XLABEL	 XLABEL consist YHIGHEST YUNIT women in the XHIGHEST XLABEL , XSECOND have YSECOND YUNIT , XTHIRD YTHIRD YUNIT , XFOURTH YFOURTH YUNIT but the XLEAST has only YLEAST YUNIT women in the XLABEL
YHIGHEST YUNIT XHIGHEST YSECOND YUNIT XSECOND YTHIRD YUNIT XTHIRD YFOURTH YUNIT XFOURTH YLEAST XLEAST	 this chart shows women representation in different university departments showing that YHIGHEST YUNIT of those who work in XHIGHEST are woman , YSECOND YUNIT in XSECOND , YTHIRD YUNIT XTHIRD , YFOURTH YUNIT in XFOURTH and YLEAST XLEAST . contributing and enforcing the stereotype that that heavily intellectual subjects are man dominated and more creative subjects are women areas .
XHIGHEST XLABEL YHIGHEST YUNIT YLABEL XSECOND YSECOND YUNIT XLEAST XLABEL YLEAST YUNIT	 This shows the representation of women in various university departments . Most women are in the XHIGHEST XLABEL with YHIGHEST YUNIT being female , there are also a high YLABEL in XSECOND at YSECOND YUNIT . XLEAST is the lowest represented XLABEL only making up YLEAST YUNIT of staff .
XSECOND XHIGHEST XLABEL YLABEL XFOURTH XLEAST XTHIRD	 This chart shows the female representation in various university departments . We can see that both the XSECOND and XHIGHEST XLABEL have much higher female YLABEL than XFOURTH , XLEAST and XTHIRD .
YLABEL GRHIGHESTSECOND XLABEL GRFOURTHLEAST	 The graph shows the YLABEL of women represented in various university departments . We can see that they are most represented in GRHIGHESTSECOND XLABEL but least represented in GRFOURTHLEAST .
YLABEL XHIGHEST XSECOND XTHIRD XFOURTH XLEAST	 This graph shows the percentage of women per University Department . The largest YLABEL is on XHIGHEST then XSECOND , followed by XTHIRD , XFOURTH then XLEAST
