PLOTTITLE XLABEL T1AX YHIGHEST YUNIT XHIGHEST YSECOND YUNIT XSECOND YLEAST YUNIT XLEAST	 This graph shows PLOTTITLE or is a XLABEL in T1AX . YHIGHEST YUNIT XHIGHEST \\n YSECOND YUNIT XSECOND \\n YLEAST YUNIT XLEAST
XHIGHEST YHIGHEST YUNIT T1AY XSECOND YSECOND YUNIT XLEAST YLEAST YUNIT	 XHIGHEST causes YHIGHEST YUNIT of T1AY , XSECOND some YSECOND YUNIT whilst XLEAST contributes the other YLEAST YUNIT
XHIGHEST XLABEL T1AB YHIGHESTAPPROX YUNIT XSECOND YSECONDAPPROX YUNIT XLEAST XLABEL T1AB YLEASTAPPROX YUNIT	 XHIGHEST is the biggest XLABEL in T1AB at YHIGHESTAPPROX YUNIT . Then XSECOND at YSECONDAPPROX YUNIT and XLEAST is the lowest XLABEL in T1AB at YLEASTAPPROX YUNIT .
COUNT XLABEL YLABEL XHIGHEST XSECOND XLEAST GRHIGHESTSECOND	 This graph shows COUNT potential XLABEL , and breaks down their relative YLABEL . XHIGHEST emerges as the most important , followed by XSECOND . XLEAST is comparatively unimportant to these GRHIGHESTSECOND .
XLABEL XHIGHEST YHIGHEST YUNIT XSECOND YSECOND YUNIT XLEAST YLEAST YUNIT	 The table shows that the leading XLABEL is XHIGHEST ( YHIGHEST YUNIT ) , followed by XSECOND ( YSECOND YUNIT ) and finally XLEAST ( YLEAST YUNIT ) .
XLABEL XHIGHEST YHIGHEST YUNIT YLABEL XSECOND YLABEL YSECOND YUNIT XLEAST YLEAST YUNIT YLABEL	 The primary XLABEL is XHIGHEST with YHIGHEST YUNIT of YLABEL being related to this type of diet . XSECOND also contributes to significant amount of YLABEL by YSECOND YUNIT . XLEAST contributes to just YLEAST YUNIT of YLABEL .
PLOTTITLE XHIGHEST XLABEL YHIGHESTAPPROX YUNIT XSECOND XLEAST YSECOND YUNIT XLABEL XSECOND XHIGHEST XLABEL XLEAST YLEASTAPPROX YUNIT ADDLEASTSECOND YUNIT XSECOND XHIGHEST XLABEL COUNT XLABEL	 PLOTTITLE XHIGHEST is the highest XLABEL at over YHIGHESTAPPROX YUNIT only slightly behind XSECOND and XLEAST . \\n YSECOND YUNIT XLABEL is XSECOND but XHIGHEST still play a major XLABEL . \\n XLEAST is at only YLEASTAPPROX YUNIT but only ADDLEASTSECOND YUNIT less than XSECOND . \\n Although XHIGHEST are the highest XLABEL , all COUNT come into play when determining a XLABEL .
COUNT XLABEL T1AY T1AB XLABEL XHIGHEST YHIGHESTAPPROX YUNIT XLEAST YLEASTAPPROX YUNIT XSECOND YSECONDAPPROX YUNIT	 There are COUNT XLABEL represented as contributing to T1AY in T1AB . The main XLABEL represented is XHIGHEST , at YHIGHESTAPPROX YUNIT with XLEAST making up YLEASTAPPROX YUNIT and XSECOND YSECONDAPPROX YUNIT .
YLABEL COUNT XLABEL PLOTTITLE YLEASTAPPROX YUNIT XLEAST YHIGHESTAPPROX YUNIT XHIGHEST YSECONDAPPROX YUNIT XSECOND	 This graph depicts the YLABEL of COUNT XLABEL for PLOTTITLE . It says YLEASTAPPROX YUNIT is because of XLEAST , YHIGHESTAPPROX YUNIT is because of XHIGHEST , and YSECONDAPPROX YUNIT because of XSECOND .
YHIGHESTAPPROX YUNIT PLOTTITLE T1AX XHIGHEST YSECONDAPPROX YUNIT T1AY T1AX XSECOND YLEASTAPPROX YUNIT T1AX XLEAST	 YHIGHESTAPPROX YUNIT of PLOTTITLE is T1AX by XHIGHEST . Approximately YSECONDAPPROX YUNIT of T1AY was T1AX by XSECOND and approximately YLEASTAPPROX YUNIT was T1AX by XLEAST .
YLABEL PLOTTITLE YLEASTAPPROX YUNIT XLABEL XLEAST YSECONDAPPROX YUNIT XLABEL XSECOND YLABEL XLABEL XHIGHEST YHIGHESTAPPROX YUNIT	 This chart shows the YLABEL of PLOTTITLE . From the chart we see that approximately YLEASTAPPROX YUNIT of the XLABEL was from XLEAST , whereas YSECONDAPPROX YUNIT of the XLABEL came from XSECOND . The highest YLABEL of the XLABEL came from XHIGHEST with YHIGHESTAPPROX YUNIT .
PLOTTITLE YLEASTAPPROX YUNIT XLEAST YSECONDAPPROX YUNIT XSECOND XLABEL XHIGHEST YHIGHESTAPPROX YUNIT MULHIGHESTLEAST XLEAST	 This chart looked at PLOTTITLE . YLEASTAPPROX YUNIT was attributed to XLEAST YSECONDAPPROX YUNIT at XSECOND . The highest XLABEL was XHIGHEST at YHIGHESTAPPROX YUNIT which was nearly MULHIGHESTLEAST as attributable to XLEAST .
PLOTTITLE YHIGHEST YUNIT T1AY XHIGHEST YSECOND YUNIT XSECOND YLEAST YUNIT XLEAST	 This graphs illustrates the PLOTTITLE . YHIGHEST YUNIT of T1AY is caused by XHIGHEST , YSECOND YUNIT by XSECOND and YLEAST YUNIT by XLEAST .
PLOTTITLE YLABEL XLEAST YLEASTAPPROX YUNIT T1AY XSECOND YSECONDAPPROX YUNIT T1AY XHIGHEST XLABEL YHIGHESTAPPROX YUNIT XLABEL	 This chart shows the PLOTTITLE and the YLABEL . XLEAST account for just under YLEASTAPPROX YUNIT of T1AY , followed by XSECOND which accounts for YSECONDAPPROX YUNIT of T1AY , but XHIGHEST is the highest XLABEL accounting for YHIGHESTAPPROX YUNIT of the XLABEL .
PLOTTITLE YLABEL YHIGHEST YUNIT XHIGHEST XSECOND YSECOND YUNIT YLEAST YUNIT XLEAST	 Graph shows the PLOTTITLE by YLABEL . YHIGHEST YUNIT is caused by XHIGHEST , followed by XSECOND at YSECOND YUNIT and the smallest at YLEAST YUNIT is XLEAST .
GRYSECONDLEAST T1AB T1AX GRSECONDLEAST YLEASTAPPROX YUNIT T1AX XLEAST YSECONDAPPROX YUNIT XSECOND	 This chart shows the GRYSECONDLEAST in T1AB is T1AX by GRSECONDLEAST , with YLEASTAPPROX YUNIT T1AX by XLEAST and YSECONDAPPROX YUNIT due to a XSECOND .
PLOTTITLE XLABEL XHIGHEST YHIGHESTAPPROX YUNIT XSECOND YSECONDAPPROX YUNIT XLABEL COUNT XLEAST YLEASTAPPROX YUNIT	 Graph above shows PLOTTITLE . The highest XLABEL was XHIGHEST at YHIGHESTAPPROX YUNIT , XSECOND came in at YSECONDAPPROX YUNIT and the lowest XLABEL out of COUNT was XLEAST at YLEASTAPPROX YUNIT
XHIGHEST XLABEL YHIGHEST YUNIT XSECOND YSECOND YUNIT XLEAST YLEAST YUNIT	 XHIGHEST is the major XLABEL at YHIGHEST YUNIT . XSECOND plays a significant role at YSECOND YUNIT . XLEAST is only YLEAST YUNIT .
XHIGHEST XLABEL YHIGHEST YUNIT YLABEL MULHIGHESTSECOND XLABEL XSECOND YSECOND YUNIT MULHIGHESTLEAST XLEAST YLEAST YUNIT YLABEL	 XHIGHEST is the highest XLABEL with YHIGHEST YUNIT of YLABEL . It is MULHIGHESTSECOND the next highest XLABEL - XSECOND on YSECOND YUNIT and MULHIGHESTLEAST XLEAST which only causes YLEAST YUNIT of YLABEL .
PLOTTITLE YLABEL XLABEL XHIGHEST YHIGHESTAPPROX YUNIT XSECOND YSECONDAPPROX YUNIT XLEAST YLEASTAPPROX YUNIT	 This chart shows PLOTTITLE . The biggest YLABEL for the XLABEL , according to this , is a XHIGHEST , which is at YHIGHESTAPPROX YUNIT . Then XSECOND at YSECONDAPPROX YUNIT . And then XLEAST at YLEASTAPPROX YUNIT .
XHIGHEST MULHIGHESTSECOND XSECOND T1AX T1AY XLEAST YLEAST YUNIT T1AX T1AY	 The chat shows that XHIGHEST is MULHIGHESTSECOND as likely as XSECOND to T1AX T1AY . It also shows that XLEAST is only YLEAST YUNIT likely to T1AX T1AY .
PLOTTITLE YHIGHEST YUNIT XHIGHEST YSECOND XSECOND YLEAST YUNIT YLABEL XLEAST	 This is a graph showing PLOTTITLE . It shows YHIGHEST YUNIT of it ' s caused by XHIGHEST , a YSECOND of it is due to XSECOND , and just under YLEAST YUNIT of YLABEL is due to XLEAST .
PLOTTITLE XLABEL YHIGHESTAPPROX YUNIT T1AY XHIGHEST XSECOND YSECONDAPPROX YUNIT T1AY XLEAST XLABEL YLEASTAPPROX YUNIT T1AY	 This chart shows the PLOTTITLE . \\n The biggest XLABEL , shown to be responsible for YHIGHESTAPPROX YUNIT of T1AY , is XHIGHEST . XSECOND accounts for YSECONDAPPROX YUNIT of T1AY and XLEAST is the XLABEL in nearly YLEASTAPPROX YUNIT of T1AY .
PLOTTITLE XLABEL XHIGHEST YHIGHEST YUNIT XSECOND YSECOND YUNIT XLEAST YLEAST YUNIT	 this graph shows the PLOTTITLE , the greatest XLABEL is XHIGHEST with YHIGHEST YUNIT follows by XSECOND with YSECOND YUNIT and XLEAST making up the remaining YLEAST YUNIT
PLOTTITLE XLABEL XHIGHEST YHIGHESTAPPROX YUNIT XLEAST YLABEL YLEASTAPPROX YUNIT XSECOND YSECONDAPPROX YUNIT	 The PLOTTITLE are charted above to show that the predominant XLABEL was found to be XHIGHEST at YHIGHESTAPPROX YUNIT . XLEAST was the lowest charted YLABEL at YLEASTAPPROX YUNIT with XSECOND only contributing YSECONDAPPROX YUNIT towards the outcome .
PLOTTITLE XLABEL XHIGHEST YHIGHESTAPPROX YUNIT XSECOND YSECONDAPPROX YUNIT XLEAST YLEASTAPPROX YUNIT	 This graph shows PLOTTITLE . THe most common XLABEL is XHIGHEST with YHIGHESTAPPROX YUNIT followed by XSECOND at YSECONDAPPROX YUNIT and XLEAST as YLEASTAPPROX YUNIT
PLOTTITLE XLEAST XLABEL YLEASTAPPROX YUNIT XSECOND YSECONDAPPROX YUNIT XHIGHEST XLABEL YHIGHESTAPPROX YUNIT	 Bar chart showing the PLOTTITLE . \\n \\n XLEAST is the lowest XLABEL at YLEASTAPPROX YUNIT , then XSECOND at YSECONDAPPROX YUNIT , with XHIGHEST as the main XLABEL at YHIGHESTAPPROX YUNIT .
XHIGHEST XLABEL XSECOND XLEAST	 This chart shows that XHIGHEST is the most likely XLABEL on average , followed by XSECOND , and is least likely to be caused by XLEAST .
PLOTTITLE XHIGHEST YLABEL YHIGHEST YUNIT XSECOND YSECOND YUNIT XLEAST YLEAST YUNIT	 The chart shows PLOTTITLE . We can see that XHIGHEST accounts for a high YLABEL of this at YHIGHEST YUNIT whilst XSECOND follows at YSECOND YUNIT and XLEAST at YLEAST YUNIT .
PLOTTITLE YLABEL XHIGHEST YHIGHEST YUNIT XSECOND YSECOND YUNIT XLEAST YLEAST YUNIT	 This chart displays PLOTTITLE . The highest YLABEL cases would be because of XHIGHEST at YHIGHEST YUNIT , followed by XSECOND at YSECOND YUNIT and then XLEAST at YLEAST YUNIT .
XHIGHEST XLABEL YHIGHEST YUNIT XSECOND YSECOND YUNIT XLEAST YLEAST YUNIT	 XHIGHEST is the leading XLABEL at YHIGHEST YUNIT , followed by XSECOND at YSECOND YUNIT and a XLEAST at YLEAST YUNIT
PLOTTITLE COUNT XLABEL XLABEL XHIGHEST YHIGHEST YUNIT XLABEL XSECOND YSECOND YUNIT XLEAST YLEAST YUNIT	 The chart represents what PLOTTITLE are and the bar chart shows the following COUNT XLABEL . The largest XLABEL is due to the XHIGHEST . This contributes to YHIGHEST YUNIT of the XLABEL . This is followed by XSECOND at YSECOND YUNIT and finally a XLEAST at YLEAST YUNIT .
XHIGHEST T1AX T1AY	 XHIGHEST is the highest factors in T1AX T1AY
COUNT PLOTTITLE YLABEL XLABEL XHIGHEST T1AX YHIGHESTAPPROX YUNIT XSECOND YSECONDAPPROX YUNIT XLEAST T1AX YLEASTAPPROX YUNIT T0AY	 The graph shows COUNT PLOTTITLE , as a YLABEL of incidence . The most common XLABEL is XHIGHEST , identified as T1AX YHIGHESTAPPROX YUNIT , with XSECOND second at YSECONDAPPROX YUNIT . XLEAST is third , T1AX YLEASTAPPROX YUNIT of T0AY .
XLABEL T1AB XHIGHEST YHIGHESTAPPROX YUNIT XSECOND YSECONDAPPROX YUNIT XLEAST YLEASTAPPROX YUNIT	 The biggest XLABEL in T1AB is XHIGHEST , accounting for YHIGHESTAPPROX YUNIT . XSECOND is YSECONDAPPROX YUNIT and XLEAST YLEASTAPPROX YUNIT .
PLOTTITLE XLABEL XHIGHEST YHIGHESTAPPROX YUNIT GRSECONDLEAST XLABEL GRSECONDLEAST XLABEL GRYSECONDLEAST YUNIT T1AY XSECOND YSECONDAPPROX YUNIT XLEAST YLEASTAPPROX YUNIT	 PLOTTITLE is seen here . The biggest XLABEL is XHIGHEST at YHIGHESTAPPROX YUNIT . However GRSECONDLEAST are a larger XLABEL with GRSECONDLEAST combined shown to XLABEL in GRYSECONDLEAST YUNIT of T1AY . \\n This is broken down into XSECOND at YSECONDAPPROX YUNIT and XLEAST at YLEASTAPPROX YUNIT .
