YHIGHEST YUNIT XHIGHEST YTHIRD YUNIT XTHIRD YLEAST YUNIT XLEAST YLABEL XSECOND	 This graph represents how young people spend their leisure time in the evenings . YHIGHEST YUNIT spend their evenings XHIGHEST , YTHIRD YUNIT spend it XTHIRD , YLEAST YUNIT are XLEAST whilst 30 YLABEL are XSECOND .
YHIGHEST YUNIT XHIGHEST YSECOND YUNIT XSECOND YTHIRD YUNIT XTHIRD YLEAST YUNIT XLEAST	 the table shows that YHIGHEST YUNIT of young people XHIGHEST in the evenings , YSECOND YUNIT XSECOND , YTHIRD YUNIT spend their evening XTHIRD , and YLEAST YUNIT XLEAST .
YLABEL XHIGHEST YHIGHEST YUNIT YSECOND YUNIT XSECOND YTHIRD YUNIT XTHIRD MULTHIRDHIGHEST XHIGHEST YLEAST YUNIT XLEAST	 A high YLABEL of young people XHIGHEST ( YHIGHEST YUNIT ) ; this figure presumably applies to pre-internet days . YSECOND YUNIT XSECOND for the evening . YTHIRD YUNIT XTHIRD , exactly MULTHIRDHIGHEST of those XHIGHEST , so they are not watching TV with their families in this case . YLEAST YUNIT XLEAST .
XHIGHEST XSECOND XLEAST	 Young people are more likely to XHIGHEST and XSECOND rather than XLEAST
XHIGHEST YHIGHEST YUNIT XLABEL XSECOND YSECOND YUNIT XTHIRD YTHIRD YUNIT YLEAST YUNIT XLEAST	 This graph shows the activities young people undertake in the evenings . Most young people spend their evenings XHIGHEST this accounts for YHIGHEST YUNIT . The next XLABEL is XSECOND with YSECOND YUNIT , then XTHIRD at YTHIRD YUNIT and lastly only YLEAST YUNIT of young people XLEAST in the evening . The lack of book reading is probably due to more technology being ready accessible
YLABEL XHIGHEST XSECOND YLABEL XTHIRD XLEAST	 This chart shows how young people spend their evenings . We can see that a high YLABEL XHIGHEST or XSECOND whilst a much smaller YLABEL XTHIRD or XLEAST .
YHIGHEST YUNIT XHIGHEST YSECOND YUNIT XSECOND YTHIRD YUNIT XTHIRD YLEAST YUNIT XLEAST	 This graph shows how young people spend their evenings . YHIGHEST YUNIT of them XHIGHEST , YSECOND YUNIT XSECOND , YTHIRD YUNIT XTHIRD , and YLEAST YUNIT XLEAST .
YHIGHEST YUNIT XHIGHEST XSECOND YSECOND YUNIT XTHIRD YTHIRD YUNIT XLEAST YLEAST YUNIT	 this graph shows how young people spend their evenings , most young people ( YHIGHEST YUNIT ) choose XHIGHEST , followed by XSECOND ( YSECOND YUNIT ) , XTHIRD ( YTHIRD YUNIT ) or XLEAST ( YLEAST YUNIT ) . reading may be the least poplar as it is considered a older hobby and a more feminine hobby .
YLEAST YUNIT XLEAST XLABEL XHIGHEST YHIGHEST YUNIT YSECOND YUNIT XSECOND YTHIRD YUNIT XTHIRD	 This graphs shows how young people spend their evenings . It highlights that only YLEAST YUNIT of people spend evenings XLEAST . The most popular XLABEL is XHIGHEST with YHIGHEST YUNIT of people spending their evenings doing that . YSECOND YUNIT of people XSECOND and YTHIRD YUNIT XTHIRD .
YLABEL XHIGHEST XSECOND XTHIRD XLEAST	 This graph shows how young people spend their evenings . The highest YLABEL is spent XHIGHEST followed by XSECOND , XTHIRD and finally XLEAST .
XLABEL XHIGHEST YHIGHEST YUNIT XSECOND YSECOND YUNIT XTHIRD YTHIRD YUNIT XLABEL XLEAST YLEAST YUNIT	 This chart demonstrates how young people spend their evenings . The most popular XLABEL is XHIGHEST , with YHIGHEST YUNIT of young people doing this , while XSECOND is second most popular at YSECOND YUNIT and XTHIRD third at YTHIRD YUNIT . The least popular XLABEL is XLEAST , at YLEAST YUNIT .
YHIGHEST YUNIT XHIGHEST XSECOND YSECOND YUNIT YTHIRD YUNIT XTHIRD YLEAST YUNIT XLEAST	 YHIGHEST YUNIT of young people spend their evenings XHIGHEST , with XSECOND close behind on YSECOND YUNIT . Only YTHIRD YUNIT XTHIRD and a disappointing YLEAST YUNIT XLEAST .
YLABEL YHIGHEST YUNIT XHIGHEST YSECOND YUNIT XSECOND XTHIRD YTHIRD YUNIT XLEAST YLEAST YUNIT	 This chart shows how young people spend their evenings by YLABEL . YHIGHEST YUNIT XHIGHEST , YSECOND YUNIT XSECOND . The rest with XTHIRD ( YTHIRD YUNIT ) or XLEAST ( YLEAST YUNIT ) .
XHIGHEST XLEAST	 The chart shows that the majority of young people spend their evenings XHIGHEST . XLEAST is the least popular way for young people to spend their time
XHIGHEST	 Most young people spend their evenings XHIGHEST
YHIGHEST YUNIT XHIGHEST XLABEL XLABEL XLEAST YLEAST YUNIT	 This bar chart shows how young people spend their evenings . YHIGHEST YUNIT of young people spend their evenings XHIGHEST ( the most common XLABEL ) , while the least common XLABEL is XLEAST ( ~ YLEAST YUNIT ) . it is unclear if young people could say that they do more than one of these things .
YLABEL YHIGHEST YUNIT XHIGHEST YSECOND YUNIT XSECOND YTHIRD YUNIT XTHIRD YLABEL YLEAST YUNIT XLEAST	 The chart shows what young people do in the evenings . The largest YLABEL YHIGHEST YUNIT XHIGHEST , followed by YSECOND YUNIT that XSECOND , then YTHIRD YUNIT XTHIRD and the smallest YLABEL at YLEAST YUNIT XLEAST .
XHIGHEST YHIGHEST YUNIT YSECOND YUNIT XSECOND YTHIRD YUNIT XTHIRD YLEAST YUNIT XLEAST	 XHIGHEST is how YHIGHEST YUNIT young people spend their evenings , YSECOND YUNIT XSECOND , YTHIRD YUNIT XTHIRD and YLEAST YUNIT XLEAST
XHIGHEST YHIGHEST YLABEL YSECOND YUNIT XSECOND YLEAST YUNIT XLEAST MULTHIRDLEAST XTHIRD	 Most young people spend their evening XHIGHEST at YHIGHEST YLABEL doing this compared with YSECOND YUNIT XSECOND . Only YLEAST YUNIT XLEAST with MULTHIRDLEAST that XTHIRD .
YHIGHEST YUNIT XHIGHEST YSECOND YUNIT XSECOND YTHIRD YUNIT XTHIRD YLEAST YUNIT XLEAST	 YHIGHEST YUNIT of young people spend their evenings XHIGHEST , YSECOND YUNIT prefer to XSECOND , YTHIRD YUNIT XTHIRD and only YLEAST YUNIT choose to spend time XLEAST in the evenings
