PLOTTITLE YLEAST YUNIT XLEAST YSECOND YUNIT T1AX XSECOND YHIGHEST YUNIT XHIGHEST YTHIRD YUNIT XTHIRD T1AX	 This chart represents PLOTTITLE . \\n Around YLEAST YUNIT XLEAST . \\n YSECOND YUNIT spend their T1AX XSECOND . \\n YHIGHEST YUNIT XHIGHEST and YTHIRD YUNIT XTHIRD in the T1AX .
PLOTTITLE YLEAST YUNIT T1AY XLEAST YSECOND YUNIT XSECOND YHIGHESTAPPROX YUNIT T0AY XHIGHEST YTHIRDAPPROX YUNIT YLABEL XTHIRD	 This chart shows PLOTTITLE . Approximately YLEAST YUNIT of T1AY XLEAST , YSECOND YUNIT XSECOND and YHIGHESTAPPROX YUNIT of T0AY XHIGHEST . About YTHIRDAPPROX YUNIT of YLABEL XTHIRD .
PLOTTITLE YLEAST YUNIT T1AY T0AY XLEAST T1AX YSECOND YUNIT T1AX XSECOND YLABEL T0AX XHIGHEST YHIGHEST YUNIT T0AY YTHIRD YUNIT T0AY T1AX XTHIRD	 This chart shows PLOTTITLE . YLEAST YUNIT of T1AY spend their T0AY XLEAST in the T1AX , YSECOND YUNIT spend their T1AX XSECOND , the highest YLABEL spend their T0AX XHIGHEST being YHIGHEST YUNIT of T0AY , and YTHIRD YUNIT of T0AY spend their T1AX XTHIRD .
PLOTTITLE YLABEL YHIGHEST YUNIT XHIGHEST YSECOND YUNIT XSECOND XTHIRD YTHIRD YUNIT XLEAST YLEAST YUNIT	 This chart shows PLOTTITLE by YLABEL . YHIGHEST YUNIT XHIGHEST , YSECOND YUNIT XSECOND . The rest with XTHIRD ( YTHIRD YUNIT ) or XLEAST ( YLEAST YUNIT ) .
YLABEL T1AB T1AX XHIGHEST YHIGHEST YUNIT XLABEL T1AX XLEAST YLEAST YUNIT	 The majority of YLABEL in T1AB spend their T1AX XHIGHEST , at YHIGHEST YUNIT . The least popular XLABEL to spend the T1AX is by XLEAST , at YLEAST YUNIT .
T1AY T1AB T1AX XHIGHEST XSECOND YLABEL YSECOND YUNIT XSECOND YHIGHEST YUNIT XHIGHEST YTHIRD YUNIT T1AY XTHIRD YLEAST YUNIT XLEAST	 The T1AY of T1AB spend the majority of their T1AX XHIGHEST and XSECOND . On the chart this has been represented as a YLABEL at a given time . YSECOND YUNIT choose to XSECOND whereas YHIGHEST YUNIT choose to XHIGHEST . YTHIRD YUNIT of the T1AY chose to XTHIRD and YLEAST YUNIT choose to XLEAST .
PLOTTITLE T1AY YHIGHEST YUNIT XHIGHEST XSECOND YSECOND YUNIT XTHIRD YTHIRD YUNIT XLEAST YLEAST YUNIT	 this graph shows PLOTTITLE , most T1AY ( YHIGHEST YUNIT ) choose XHIGHEST , followed by XSECOND ( YSECOND YUNIT ) , XTHIRD ( YTHIRD YUNIT ) or XLEAST ( YLEAST YUNIT ) . reading may be the least poplar as it is considered a older hobby and a more feminine hobby .
PLOTTITLE XLABEL XLABEL XLEAST YLEAST YUNIT XHIGHEST XSECOND XLABEL YHIGHEST YSECOND YUNIT	 This graph demonstrates PLOTTITLE by XLABEL . The least popular XLABEL is XLEAST at YLEAST YUNIT . XHIGHEST and XSECOND are the most popular XLABEL at YHIGHEST and YSECOND YUNIT respectively .
PLOTTITLE YLEAST YUNIT T1AY T1AX XLEAST XLABEL XHIGHEST YHIGHEST YUNIT T1AY T1AX YSECOND YUNIT T1AY XSECOND YTHIRD YUNIT XTHIRD	 This graphs shows PLOTTITLE . It highlights that only YLEAST YUNIT of T1AY spend T1AX XLEAST . The most popular XLABEL is XHIGHEST with YHIGHEST YUNIT of T1AY spending their T1AX doing that . YSECOND YUNIT of T1AY XSECOND and YTHIRD YUNIT XTHIRD .
PLOTTITLE T1AY T1AX XHIGHEST YHIGHEST YUNIT XLABEL XSECOND YSECOND YUNIT XTHIRD YTHIRD YUNIT YLEAST YUNIT T1AY XLEAST T1AX	 This graph shows the PLOTTITLE . Most T1AY spend their T1AX XHIGHEST this accounts for YHIGHEST YUNIT . The next XLABEL is XSECOND with YSECOND YUNIT , then XTHIRD at YTHIRD YUNIT and lastly only YLEAST YUNIT of T1AY XLEAST in the T1AX . The lack of book reading is probably due to more technology being ready accessible
PLOTTITLE YLABEL XHIGHEST XSECOND XTHIRD XLEAST	 This graph shows PLOTTITLE . The highest YLABEL is spent XHIGHEST followed by XSECOND , XTHIRD and finally XLEAST .
PLOTTITLE YHIGHEST YUNIT XHIGHEST YSECOND YUNIT XSECOND YTHIRD YUNIT XTHIRD YLEAST YUNIT XLEAST	 This graph shows PLOTTITLE . YHIGHEST YUNIT of them XHIGHEST , YSECOND YUNIT XSECOND , YTHIRD YUNIT XTHIRD , and YLEAST YUNIT XLEAST .
PLOTTITLE YLABEL XLABEL BARNAMES XHIGHEST YHIGHEST YUNIT XLABEL XLEAST YLEAST YUNIT	 The graph details PLOTTITLE , presented as a YLABEL . The XLABEL listed are BARNAMES . XHIGHEST proved to be the most popular with YHIGHEST YUNIT choosing this XLABEL , while XLEAST , at YLEAST YUNIT was the least popular .
T1AY T1AB T1AX XHIGHEST YHIGHEST YUNIT YLEASTAPPROX YUNIT XLEAST XTHIRD YTHIRD YUNIT XSECOND XHIGHEST YSECONDAPPROX YUNIT	 T1AY in T1AB spend their T1AX XHIGHEST - over YHIGHEST YUNIT compared to YLEASTAPPROX YUNIT XLEAST & XTHIRD - at YTHIRD YUNIT . \\n XSECOND comes second to XHIGHEST at YSECONDAPPROX YUNIT .
PLOTTITLE T1AY T1AX XHIGHEST YHIGHESTAPPROX YUNIT YSECOND YUNIT XSECOND YTHIRDAPPROX YUNIT XTHIRD YLEAST YUNIT T1AX XLEAST	 This chart shows PLOTTITLE . According to the chart , most T1AY spend their T1AX XHIGHEST - YHIGHESTAPPROX YUNIT of them . Around YSECOND YUNIT of them XSECOND . YTHIRDAPPROX YUNIT of them XTHIRD and just YLEAST YUNIT spend their T1AX XLEAST .
YHIGHEST YUNIT T1AY T1AX XHIGHEST XSECOND YSECOND YUNIT YTHIRD YUNIT XTHIRD YLEAST YUNIT XLEAST	 YHIGHEST YUNIT of T1AY spend their T1AX XHIGHEST , with XSECOND close behind on YSECOND YUNIT . Only YTHIRD YUNIT XTHIRD and a disappointing YLEAST YUNIT XLEAST .
PLOTTITLE T1AY T1AX XHIGHEST YHIGHEST YUNIT XSECOND YSECOND YUNIT XTHIRD YTHIRD YUNIT YLEAST YUNIT T0AX XLEAST	 PLOTTITLE . Most T1AY spend their T1AX XHIGHEST , at YHIGHEST YUNIT . Next common is XSECOND , at YSECOND YUNIT . Then XTHIRD at YTHIRD YUNIT . The final YLEAST YUNIT spends T0AX XLEAST . I 'm not sure what the other 10 % do .
PLOTTITLE YLABEL XHIGHEST XSECOND YLABEL XTHIRD XLEAST	 This chart shows PLOTTITLE . We can see that a high YLABEL XHIGHEST or XSECOND whilst a much smaller YLABEL XTHIRD or XLEAST .
T1AY T1AX XHIGHEST YHIGHEST YLABEL YSECOND YUNIT XSECOND YLEAST YUNIT XLEAST MULTHIRDLEAST XTHIRD	 Most T1AY spend their T1AX XHIGHEST at YHIGHEST YLABEL doing this compared with YSECOND YUNIT XSECOND . Only YLEAST YUNIT XLEAST with MULTHIRDLEAST that XTHIRD .
YLABEL PLOTTITLE YLABEL T1AX XLEAST YLEAST YUNIT YTHIRD YUNIT T1AY XTHIRD YSECOND YUNIT T1AY XSECOND YLABEL T1AY XHIGHEST YHIGHEST YUNIT	 This chart shows the YLABEL on PLOTTITLE . From the chart , we see that the smallest YLABEL spend their T1AX XLEAST at around YLEAST YUNIT . This is then followed by YTHIRD YUNIT of T1AY XTHIRD . We then see YSECOND YUNIT T1AY XSECOND but the highest YLABEL of T1AY are XHIGHEST at around YHIGHEST YUNIT .
YLABEL T1AB T1AX XHIGHEST XTHIRD YHIGHESTAPPROX YUNIT T1AY XHIGHEST YTHIRDAPPROX YUNIT XTHIRD XLEAST XLABEL YLEAST YUNIT T1AY T1AB T1AX XLEAST	 More YLABEL in T1AB spend their T1AX XHIGHEST than XTHIRD . YHIGHESTAPPROX YUNIT of T1AY XHIGHEST compared with YTHIRDAPPROX YUNIT who XTHIRD . \\n \\n XLEAST is the least popular XLABEL , with only YLEAST YUNIT of T1AY in T1AB spending their T1AX XLEAST .
PLOTTITLE XLABEL YLEAST YUNIT T1AY T0AY XLEAST T1AX YSECONDAPPROX YUNIT XSECOND YHIGHEST YUNIT XHIGHEST YTHIRD YUNIT XTHIRD	 This graph depicts PLOTTITLE from the XLABEL assigned to the research . YLEAST YUNIT of T1AY spent T0AY XLEAST in the T1AX ; YSECONDAPPROX YUNIT XSECOND , YHIGHEST YUNIT XHIGHEST , and YTHIRD YUNIT XTHIRD .
YLABEL T1AY T1AB T1AX XHIGHEST YHIGHEST YUNIT XSECOND YLABEL T0AX XTHIRD YLEAST YUNIT T0AX XLEAST	 The highest YLABEL of T1AY in T1AB spend their T1AX XHIGHEST ( YHIGHEST YUNIT ) then XSECOND . A lower YLABEL spend their T0AX XTHIRD , with only YLEAST YUNIT spend their T0AX XLEAST .
XHIGHEST YHIGHEST YUNIT T1AY T1AX YSECOND YUNIT XSECOND YTHIRD YUNIT XTHIRD YLEAST YUNIT XLEAST	 XHIGHEST is how YHIGHEST YUNIT T1AY spend their T1AX , YSECOND YUNIT XSECOND , YTHIRD YUNIT XTHIRD and YLEAST YUNIT XLEAST
T1AY T1AX XHIGHEST XLEAST T1AY T0AX	 The chart shows that the majority of T1AY spend their T1AX XHIGHEST . XLEAST is the least popular way for T1AY to spend their T0AX
T1AY T1AX XHIGHEST	 Most T1AY spend their T1AX XHIGHEST
PLOTTITLE YHIGHEST YUNIT T1AX XHIGHEST YTHIRD YUNIT XTHIRD YLEAST YUNIT XLEAST YLABEL XSECOND	 This graph represents PLOTTITLE . YHIGHEST YUNIT spend their T1AX XHIGHEST , YTHIRD YUNIT spend it XTHIRD , YLEAST YUNIT are XLEAST whilst 30 YLABEL are XSECOND .
YLABEL T1AY XHIGHEST YHIGHEST YUNIT YSECOND YUNIT XSECOND T1AX YTHIRD YUNIT XTHIRD MULTHIRDHIGHEST XHIGHEST YLEAST YUNIT XLEAST	 A high YLABEL of T1AY XHIGHEST ( YHIGHEST YUNIT ) ; this figure presumably applies to pre-internet days . YSECOND YUNIT XSECOND for the T1AX . YTHIRD YUNIT XTHIRD , exactly MULTHIRDHIGHEST of those XHIGHEST , so they are not watching TV with their families in this case . YLEAST YUNIT XLEAST .
YHIGHEST YUNIT T1AY XHIGHEST T1AX YSECOND YUNIT XSECOND YTHIRD YUNIT T1AX XTHIRD YLEAST YUNIT XLEAST	 the table shows that YHIGHEST YUNIT of T1AY XHIGHEST in the T1AX , YSECOND YUNIT XSECOND , YTHIRD YUNIT spend their T1AX XTHIRD , and YLEAST YUNIT XLEAST .
PLOTTITLE YLEAST YUNIT T1AX XLEAST YSECOND YUNIT XSECOND YHIGHEST YUNIT XHIGHEST YTHIRD YUNIT XTHIRD T1AY T1AX XHIGHEST YLABEL XLEAST	 This chart shows the PLOTTITLE . YLEAST YUNIT are seen to spend their T1AX XLEAST , YSECOND YUNIT XSECOND , YHIGHEST YUNIT XHIGHEST and only YTHIRD YUNIT XTHIRD . Overall the chart shows that more T1AY spend their T1AX XHIGHEST , and the lowest YLABEL spend it XLEAST .
PLOTTITLE YLEASTAPPROX YUNIT XLEAST YTHIRD YUNIT XTHIRD YSECOND YUNIT XSECOND YHIGHEST YUNIT XHIGHEST	 Bar chart showing PLOTTITLE . \\n \\n YLEASTAPPROX YUNIT XLEAST , YTHIRD YUNIT XTHIRD , YSECOND YUNIT XSECOND , while YHIGHEST YUNIT prefer to XHIGHEST .
PLOTTITLE XLEAST XLABEL YLEASTAPPROX YUNIT T1AY T0AX COUNT XLABEL YHIGHEST YUNIT XHIGHEST YSECOND YUNIT XSECOND YTHIRDAPPROX YUNIT XTHIRD	 In this chart we can see PLOTTITLE . \\n XLEAST is an XLABEL that just over YLEASTAPPROX YUNIT of T1AY spend T0AX doing . That is the lowest of the COUNT XLABEL presented . About YHIGHEST YUNIT XHIGHEST and YSECOND YUNIT XSECOND , while only YTHIRDAPPROX YUNIT XTHIRD .
T1AY XHIGHEST XSECOND XLEAST	 T1AY are more likely to XHIGHEST and XSECOND rather than XLEAST
PLOTTITLE GRYSECONDTHIRD YUNIT GRSECONDTHIRD GRYHIGHESTLEAST YUNIT GRHIGHESTLEAST YSECOND YUNIT T0AY GRSECONDTHIRD XSECOND YTHIRD YUNIT XTHIRD T0AY GRHIGHESTLEAST YHIGHEST YUNIT XHIGHEST YLEAST YUNIT XLEAST	 This chart shows PLOTTITLE . With GRYSECONDTHIRD YUNIT choosing to GRSECONDTHIRD and the other GRYHIGHESTLEAST YUNIT choosing GRHIGHESTLEAST . This is broken down with YSECOND YUNIT of the T0AY who prefer to GRSECONDTHIRD like to XSECOND and the remaining YTHIRD YUNIT choosing to XTHIRD . \\n The T0AY who prefer opting for GRHIGHESTLEAST are split with YHIGHEST YUNIT preferring to XHIGHEST , while the remaining YLEAST YUNIT prefer to XLEAST .
PLOTTITLE XLABEL XHIGHEST YHIGHEST YUNIT T1AY XSECOND YSECOND YUNIT XTHIRD YTHIRD YUNIT XLABEL XLEAST YLEAST YUNIT	 This chart demonstrates PLOTTITLE . The most popular XLABEL is XHIGHEST , with YHIGHEST YUNIT of T1AY doing this , while XSECOND is second most popular at YSECOND YUNIT and XTHIRD third at YTHIRD YUNIT . The least popular XLABEL is XLEAST , at YLEAST YUNIT .
