YLABEL T1AB XSTART XHIGHEST XEND XLEAST YLABEL XTHIRD ADDTHIRDSECOND YLABEL XTHIRD	 The YLABEL at the T1AB was decreasing XSTART XHIGHEST XEND XLEAST . The YLABEL decreased most dramatically in XTHIRD , with ADDTHIRDSECOND less YLABEL occurring in XTHIRD .
YLABEL T1AB INTERVAL XLABEL XHIGHEST YHIGHEST YUNIT YLEAST YUNIT XLEAST	 this chart shows the YLABEL at the T1AB has decreased over INTERVAL XLABEL . In XHIGHEST , there were YHIGHEST YUNIT and this has reduced year by year , to YLEAST YUNIT in XLEAST .
PLOTTITLE XSTART XLABEL XSECOND XEND XFOURTH XLABEL XSECOND YSECOND YUNIT XHIGHEST YHIGHEST YUNIT XTHIRD YTHIRD YUNIT XLEAST YLEAST YUNIT XFOURTH YLABEL YFOURTH	 This chart shows the PLOTTITLE XSTART the XLABEL XSECOND XEND XFOURTH . From the chart , we can see that in the XLABEL XSECOND , we saw YSECOND YUNIT which was followed by a huge increase in XHIGHEST with YHIGHEST YUNIT . We then saw a drop in XTHIRD with around YTHIRD YUNIT with was followed by another drop in XLEAST with YLEAST YUNIT . Finally in XFOURTH , we saw an increase of YLABEL by YFOURTH .
YLABEL T1AB XLABEL XHIGHEST YHIGHEST XSECOND YSECOND XTHIRD YTHIRD XFOURTH YLABEL YFOURTH XLEAST YLEAST	 The highest YLABEL at the T1AB took place in the XLABEL XHIGHEST at YHIGHEST . In XSECOND the percentage was YSECOND and in XTHIRD , YTHIRD . In XFOURTH the YLABEL was YFOURTH and at its lowest in XLEAST at YLEAST .
YLABEL T1AB YSECOND XSECOND YHIGHEST XHIGHEST XTHIRD YTHIRD YLEAST XLEAST XFOURTH YFOURTH YUNIT	 The YLABEL at the T1AB started at YSECOND in XSECOND , this increased to YHIGHEST in XHIGHEST . In XTHIRD this dropped back to YTHIRD and then a further drop to YLEAST in XLEAST . However in XFOURTH there was a slight increase to YFOURTH YUNIT .
PLOTTITLE XLABEL YLABEL XHIGHEST YHIGHEST YSECOND XSECOND YTHIRD XTHIRD XFOURTH YFOURTH YUNIT XLEAST YLABEL XEND YLEAST	 This chart shows the PLOTTITLE for a number of XLABEL . \\n \\n The YLABEL in XHIGHEST was YHIGHEST , this dropped to YSECOND in XSECOND and decreased to YTHIRD in XTHIRD . In XFOURTH , YFOURTH YUNIT were recorded , whilst in XLEAST the YLABEL dropped XEND YLEAST .
PLOTTITLE XSTART XHIGHEST XEND XLEAST XHIGHEST YLABEL YHIGHEST YUNIT INTERVAL GRSECONDTHIRDFOURTHLEAST XLEAST YLEAST YUNIT	 Here is a chart based on the PLOTTITLE XSTART XHIGHEST XEND XLEAST . In XHIGHEST the YLABEL was at its highest with YHIGHEST YUNIT . Each INTERVAL GRSECONDTHIRDFOURTHLEAST has dramatically reduced year on year . In XLEAST it 's at its lowest with approximately YLEAST YUNIT .
PLOTTITLE INTERVAL XLABEL XSTART XHIGHEST XEND XLEAST YLABEL YHIGHEST XHIGHEST YLEAST XLEAST	 This chart represents the PLOTTITLE across INTERVAL XLABEL XSTART XHIGHEST XEND XLEAST . \\n \\n There is a downward trend in the YLABEL , falling from YHIGHEST in XHIGHEST to YLEAST in XLEAST .
YLABEL T1AB YHIGHEST YUNIT XHIGHEST YLEAST YUNIT XLEAST	 The YLABEL at the T1AB has fluctuated over the years recorded . Compared to a high of YHIGHEST YUNIT in XHIGHEST , YLEAST YUNIT in XLEAST .
PLOTTITLE XSTART XHIGHEST XEND XLEAST XHIGHEST YHIGHEST YUNIT YSECOND XSECOND XTHIRD YTHIRD XFOURTH YFOURTH YUNIT XLEAST YLABEL YLEAST	 This chart shows the PLOTTITLE XSTART XHIGHEST XEND XLEAST . \\n In XHIGHEST there were YHIGHEST YUNIT . YSECOND were recorded in XSECOND . It decreased further in XTHIRD at YTHIRD . In XFOURTH there was just a slight drop at YFOURTH YUNIT . However in XLEAST it shows the lowest YLABEL at YLEAST .
YLABEL T1AB GRHIGHESTSECOND YSECONDAPPROX YUNIT XSECOND YHIGHESTAPPROX XHIGHEST XHIGHEST YLABEL YHIGHESTAPPROX XHIGHEST YFOURTH XFOURTH XLEAST YUNIT INTERVAL XLABEL YLEASTAPPROX YUNIT	 There was an increase in the YLABEL at the T1AB GRHIGHESTSECOND . Increasing from just over YSECONDAPPROX YUNIT in XSECOND to over YHIGHESTAPPROX in XHIGHEST . \\n \\n However from XHIGHEST there has been a slight decline in the YLABEL . From just over YHIGHESTAPPROX in XHIGHEST to YFOURTH in XFOURTH . \\n \\n XLEAST saw the lowest YUNIT over a INTERVAL XLABEL with just over YLEASTAPPROX YUNIT .
PLOTTITLE XSTART XSECOND XEND XFOURTH YLABEL YSECOND XSECOND YHIGHEST XHIGHEST XLABEL YLEAST XLEAST XFOURTH YLABEL XFOURTH YFOURTH	 We can see from the chart the PLOTTITLE XSTART XSECOND XEND XFOURTH . The YLABEL grew from YSECOND in XSECOND to YHIGHEST in XHIGHEST . Thereafter , there has been a decline over the XLABEL down to YLEAST in XLEAST . However there has been an increase in the XFOURTH and the YLABEL for XFOURTH stands at YFOURTH .
YLABEL COUNT XLABEL YLABEL GRHIGHESTTHIRDLEAST XFOURTH YLABEL XHIGHEST	 This shows the fluctuation of YLABEL over a COUNT XLABEL . It indicates a downward trend in YLABEL GRHIGHESTTHIRDLEAST although this came to an end in XFOURTH . The most YLABEL were recorded in XHIGHEST .
PLOTTITLE INTERVAL XLABEL YLABEL XHIGHEST YHIGHEST YUNIT XSECOND YSECOND YUNIT XTHIRD YTHIRD YUNIT XFOURTH YFOURTH YUNIT XLEAST YLEAST YUNIT	 The bar chart shows the PLOTTITLE . It shows that over a INTERVAL XLABEL period , the YLABEL got progressively lower . In XHIGHEST there were YHIGHEST YUNIT . In XSECOND there were YSECOND YUNIT . In XTHIRD there were approximately YTHIRD YUNIT . In XFOURTH there were YFOURTH YUNIT and in XLEAST there were approximately YLEAST YUNIT .
YLABEL T1AB INTERVAL XLABEL YLABEL YHIGHEST YUNIT XHIGHEST YLEAST YUNIT XLEAST	 This graph measures the YLABEL at T1AB over a INTERVAL XLABEL period . \\n \\n It shows that there was a steady decline in YLABEL from YHIGHEST YUNIT in XHIGHEST to YLEAST YUNIT in XLEAST .
PLOTTITLE XSTART XSECOND XEND XFOURTH XSECOND YSECOND YUNIT YHIGHEST XHIGHEST XTHIRD YTHIRD XLEAST YLEAST YFOURTH XFOURTH	 The graph shows PLOTTITLE XSTART XSECOND XEND XFOURTH inclusive . In XSECOND there were YSECOND YUNIT , rising to YHIGHEST in XHIGHEST but falling again in XTHIRD to YTHIRD . The number fell again in XLEAST , to YLEAST , but rose to YFOURTH in XFOURTH .
YLABEL XLABEL T1AB XLABEL XSECOND XEND XFOURTH YLABEL XHIGHEST YHIGHEST YUNIT YLABEL XLEAST YLEAST YUNIT XLABEL	 The graph details the YLABEL per XLABEL , at the T1AB . Covering the XLABEL XSECOND XEND XFOURTH the graph shows that the highest YLABEL occurred in XHIGHEST , with YHIGHEST YUNIT . The lowest YLABEL occurred in XLEAST , with YLEAST YUNIT that XLABEL .
YLABEL T1AB YLABEL XHIGHEST YHIGHEST YUNIT YLABEL YLEASTAPPROX YUNIT XLEAST	 The YLABEL at the T1AB showed a decrease over time . Its highest recorded YLABEL being in XHIGHEST where there were YHIGHEST YUNIT . As time went on , the YLABEL dropped significantly having YLEASTAPPROX YUNIT recorded in XLEAST .
PLOTTITLE YLABEL XLABEL XSECOND YSECOND YLABEL XHIGHEST YHIGHEST YTHIRD XTHIRD YLEAST XLEAST XFOURTH YLABEL YFOURTH	 PLOTTITLE as a graph to show YLABEL against XLABEL . XSECOND was YSECOND , the highest YLABEL occured in XHIGHEST at YHIGHEST , this reduced down to YTHIRD in XTHIRD and further down to YLEAST in XLEAST . XFOURTH this YLABEL increased to YFOURTH .
PLOTTITLE XSTART XLABEL XHIGHEST XEND XLEAST YLABEL YHIGHEST XHIGHEST YLABEL BARSREST XLABEL YLEAST XLEAST MULHIGHESTLEAST YUNIT XLABEL XHIGHEST	 This chart shows the PLOTTITLE XSTART XLABEL XHIGHEST XEND XLEAST . \\n \\n From the chart you will see that the YLABEL were YHIGHEST , at their highest in XHIGHEST . \\n The YLABEL slowly declined over the next BARSREST XLABEL to YLEAST in XLEAST . \\n This has reduced by over MULHIGHESTLEAST YUNIT compared to the XLABEL XHIGHEST .
PLOTTITLE XSTART XHIGHEST XEND XLEAST YLABEL YHIGHEST YUNIT XHIGHEST YSECOND XSECOND YTHIRD XTHIRD ADDHIGHESTFOURTH XFOURTH XEND YLEAST XLEAST XSTART XSECOND XEND XTHIRD	 This chart shows the PLOTTITLE XSTART XHIGHEST XEND XLEAST . The YLABEL has fallen each year . There were YHIGHEST YUNIT in XHIGHEST , YSECOND in XSECOND , YTHIRD in XTHIRD , ADDHIGHESTFOURTH in XFOURTH XEND YLEAST in XLEAST . The biggest drop was XSTART XSECOND XEND XTHIRD .
PLOTTITLE XSTART XHIGHEST XEND XLEAST YHIGHEST XHIGHEST YLEAST XLEAST	 This chart represents the PLOTTITLE , XSTART XHIGHEST XEND XLEAST . There has been a steady decline each year , from YHIGHEST in XHIGHEST to YLEAST in XLEAST .
PLOTTITLE XSTART XHIGHEST XEND XLEAST XHIGHEST YLABEL YHIGHEST YLEASTAPPROX XLEAST	 This shows the PLOTTITLE XSTART XHIGHEST XEND XLEAST . The highest is XHIGHEST with the YLABEL at YHIGHEST gradually decreasing to about YLEASTAPPROX in XLEAST .
PLOTTITLE XLABEL XHIGHEST YHIGHEST YUNIT XSECOND XSECOND YSECOND YUNIT XTHIRD XTHIRD GRHIGHESTSECOND YTHIRD YUNIT XLEAST YLEAST YUNIT XFOURTH YFOURTH YUNIT	 This is a chart showing the PLOTTITLE across the XLABEL . It shows a spike in XHIGHEST of YHIGHEST YUNIT . The XSECOND , XSECOND , had just YSECOND YUNIT . But the XTHIRD , XTHIRD , there were less than either GRHIGHESTSECOND with YTHIRD YUNIT , and XLEAST had less still with YLEAST YUNIT . But then XFOURTH increased again and there were YFOURTH YUNIT .
PLOTTITLE XSTART XSECOND XEND XFOURTH YMEAN YUNIT XLABEL XHIGHEST YLABEL YHIGHEST YLABEL XLEAST YLEAST YUNIT GRSECONDTHIRDFOURTH YLABEL GRYSECONDTHIRDFOURTH	 In this chart we can see the PLOTTITLE XSTART XSECOND XEND XFOURTH . \\n More than YMEAN YUNIT occurred in all of the XLABEL presented . In XHIGHEST , the YLABEL was highest at YHIGHEST . The lowest YLABEL was in XLEAST when there were YLEAST YUNIT . In the GRSECONDTHIRDFOURTH the YLABEL was around GRYSECONDTHIRDFOURTH .
YLABEL XHIGHEST YLEAST XLABEL XLEAST YLABEL XLABEL XHIGHEST YHIGHEST YUNIT XSECOND YSECOND XTHIRD YTHIRD XFOURTH YFOURTH	 The YLABEL has decreased since XHIGHEST , arriving to YLEAST for the XLABEL XLEAST . The statistics show the following YLABEL in the following XLABEL XHIGHEST , YHIGHEST YUNIT . In XSECOND YSECOND , XTHIRD YTHIRD , XFOURTH was YFOURTH .
PLOTTITLE XLABEL COUNT XLABEL XSECOND YSECOND YUNIT XHIGHEST YHIGHESTAPPROX YUNIT XTHIRD YTHIRD YUNIT XLEAST YLEAST YUNIT XFOURTH YFOURTH YUNIT	 The graph depicts the PLOTTITLE by XLABEL across COUNT XLABEL . In XSECOND there were YSECOND YUNIT , XHIGHEST there were YHIGHESTAPPROX YUNIT , XTHIRD there were YTHIRD YUNIT , XLEAST there were YLEAST YUNIT , and in XFOURTH there were YFOURTH YUNIT .
PLOTTITLE XSTART XHIGHEST XEND XLEAST YLABEL T1AB XHIGHEST YLABEL XLEAST	 This chart shows the PLOTTITLE XSTART XHIGHEST XEND XLEAST . \\n From the chart we see that the highest YLABEL at the T1AB is from XHIGHEST . We can see that there is a gradual decrease year on year with the lowest YLABEL is from XLEAST .
PLOTTITLE XSTART XHIGHEST XEND XLEAST YHIGHEST YUNIT XHIGHEST YSECOND XSECOND XTHIRD YTHIRD YUNIT YLABEL XFOURTH YFOURTH XLEAST YLABEL YLEAST	 This graph shows the PLOTTITLE XSTART XHIGHEST XEND XLEAST . There were YHIGHEST YUNIT in XHIGHEST , dropping to YSECOND in XSECOND . In XTHIRD there was another decrease with YTHIRD YUNIT . The YLABEL in XFOURTH dropped slightly to YFOURTH and there was another drop in XLEAST when the YLABEL was YLEAST .
PLOTTITLE XSTART XSECOND XEND XFOURTH YLABEL YMEAN XLABEL XHIGHEST YHIGHEST YUNIT YLEAST YUNIT XLEAST	 This graph shows the PLOTTITLE XSTART XSECOND XEND XFOURTH . We can see the YLABEL have been around an average of YMEAN a XLABEL , but it peaked in XHIGHEST with YHIGHEST YUNIT and had a low of YLEAST YUNIT is XLEAST
PLOTTITLE YLABEL YHIGHESTAPPROX YHIGHEST YLEASTAPPROX XLEAST	 The graph shows the PLOTTITLE . The YLABEL in YHIGHESTAPPROX was YHIGHEST . This has decrease significantly to YLEASTAPPROX in XLEAST .
PLOTTITLE YLABEL XHIGHEST YHIGHEST YUNIT YLABEL XLEAST YLEAST YUNIT	 The PLOTTITLE is depicted in this graph . the highest YLABEL was in XHIGHEST , with YHIGHEST YUNIT . The lowest YLABEL was in XLEAST at YLEAST YUNIT .
PLOTTITLE YHIGHEST XLEAST YLEASTAPPROX XLEAST SLOPEY SLOPEX	 This graph shows the PLOTTITLE . The trend decreases from YHIGHEST in XLEAST to YLEASTAPPROX in XLEAST , with an average decrease of SLOPEY per SLOPEX .
PLOTTITLE XSTART XSECOND XEND XFOURTH YHIGHEST YUNIT XHIGHEST YLEAST XLEAST YFOURTH XFOURTH	 Bar chart showing the PLOTTITLE XSTART XSECOND XEND XFOURTH . \\n \\n The bar chart shows a spike of YHIGHEST YUNIT in XHIGHEST , decreasing to YLEAST in XLEAST , before rising again to YFOURTH in XFOURTH .
PLOTTITLE YLABEL XSTART XLABEL XHIGHEST XEND XLABEL XLEAST YHIGHEST YUNIT XHIGHEST YSECOND XSECOND XTHIRD YTHIRD YUNIT XFOURTH YLABEL XTHIRD ADDHIGHESTFOURTH YLEAST XLEAST	 The chart shows the PLOTTITLE . \\n The signifant results show that the YLABEL has been declining XSTART XLABEL XHIGHEST up XEND XLABEL XLEAST . \\n There were YHIGHEST YUNIT in XHIGHEST , YSECOND in XSECOND and quite a large drop in XTHIRD with YTHIRD YUNIT . \\n In XFOURTH there were similar YLABEL to the XTHIRD with ADDHIGHESTFOURTH and YLEAST in XLEAST .
PLOTTITLE INTERVAL XLABEL XSTART XSECOND XEND XFOURTH XLABEL XSECOND YSECOND YUNIT T1AB XHIGHEST YHIGHEST YUNIT YLABEL YTHIRD YUNIT XTHIRD XLEAST YLEAST YUNIT XFOURTH YLABEL YFOURTH	 This chart shows the PLOTTITLE over a INTERVAL XLABEL , XSTART XSECOND XEND XFOURTH . \\n \\n From the chart we can see that in the XLABEL XSECOND , there were YSECOND YUNIT at the T1AB . This increased in XHIGHEST to YHIGHEST YUNIT . Following this , the YLABEL decreased to YTHIRD YUNIT in XTHIRD and decreased further in XLEAST to YLEAST YUNIT . \\n \\n However , in XFOURTH the YLABEL increased to YFOURTH .
