YLABEL XHIGHEST XSECOND XLABEL YLABEL XLEAST XTHIRD	 The chart shows that YLABEL is highest in XHIGHEST , followed by XSECOND . The XLABEL with the lowest YLABEL is XLEAST , followed by XTHIRD .
YLABEL PLOTTITLE YLABEL XHIGHEST YHIGHESTAPPROX YUNIT YLEAST YUNIT YLABEL XLEAST YLABEL XSECOND YSECOND YUNIT YTHIRD YUNIT XTHIRD	 The graph shows the YLABEL of PLOTTITLE . Most YLABEL in XHIGHEST with YHIGHESTAPPROX YUNIT and there are only YLEAST YUNIT of YLABEL in the XLEAST . The second highest YLABEL was XSECOND with YSECOND YUNIT followed by with YTHIRD YUNIT in XTHIRD .
T1AY T1AY XHIGHEST YHIGHEST YUNIT XSECOND YSECOND YUNIT XTHIRD YTHIRD YUNIT XLEAST YLEAST YUNIT	 The table shows that T1AY are most T1AY in XHIGHEST ( YHIGHEST YUNIT ) , followed by XSECOND ( YSECOND YUNIT ) , XTHIRD ( YTHIRD YUNIT ) , and XLEAST ( YLEAST YUNIT ) .
PLOTTITLE YTHIRD YUNIT XTHIRD T1AY T1AY YSECONDAPPROX YUNIT XSECOND XHIGHEST YHIGHEST YUNIT XLEAST YLEAST YUNIT	 This graph shows the PLOTTITLE . Almost YTHIRD YUNIT of XTHIRD consisted of T1AY , and T1AY make up over YSECONDAPPROX YUNIT of the XSECOND . The XHIGHEST is even higher at YHIGHEST YUNIT , and XLEAST come in the smallest at YLEAST YUNIT .
PLOTTITLE XHIGHEST YLABEL XSECOND XTHIRD XLEAST YLABEL YLEAST YUNIT	 This graph presents the PLOTTITLE . XHIGHEST have the highest YLABEL , followed by XSECOND and XTHIRD . XLEAST has the lowest YLABEL - YLEAST YUNIT .
YLABEL XHIGHEST YHIGHESTAPPROX YUNIT YTHIRD YUNIT YLABEL XTHIRD XLEAST YLEASTAPPROX YUNIT	 this chart demonstrates that YLABEL is largest in the XHIGHEST , at YHIGHESTAPPROX YUNIT . in comparison YTHIRD YUNIT and below of YLABEL in XTHIRD , even less is XLEAST , at YLEASTAPPROX YUNIT .
T1AY XHIGHEST XLEAST XTHIRD	 T1AY are moderately over-represented in XHIGHEST but are significantly under-represented in XLEAST and XTHIRD .
YLABEL XLABEL XHIGHEST YLABEL YHIGHEST YUNIT XLEAST YLEAST YUNIT ADDHIGHESTLEAST YUNIT XTHIRD XEND YTHIRD YUNIT	 The charts show the YLABEL in XLABEL . XHIGHEST has the highest YLABEL at YHIGHEST YUNIT whereas XLEAST has the lowest at YLEAST YUNIT - a ADDHIGHESTLEAST YUNIT difference . XTHIRD appear XEND have the most equal representation with YTHIRD YUNIT .
YLABEL PLOTTITLE XHIGHEST YHIGHESTAPPROX YUNIT XSECOND YSECONDAPPROX YUNIT XTHIRD YTHIRD YUNIT XLEAST YLEAST YUNIT	 This graph shows the YLABEL of PLOTTITLE . XHIGHEST is the highest at YHIGHESTAPPROX YUNIT , XSECOND next at YSECONDAPPROX YUNIT , then XTHIRD at YTHIRD YUNIT . XLEAST are the lowest at YLEAST YUNIT .
PLOTTITLE XLABEL YLABEL XHIGHEST YHIGHESTAPPROX YUNIT XLEAST YLEASTAPPROX YUNIT XSECOND YLABEL YSECOND YUNIT XTHIRD YTHIRD YUNIT	 The PLOTTITLE varies according to the XLABEL . The highest YLABEL can be found in the XHIGHEST with a YHIGHESTAPPROX YUNIT , while the lowest is in XLEAST with around YLEASTAPPROX YUNIT . \\n The XSECOND has a YLABEL of around YSECOND YUNIT , while the XTHIRD YTHIRD YUNIT .
T1AY T1AY XLEAST YLEAST YUNIT T1AY XTHIRD YTHIRD YUNIT XSECOND YSECOND YUNIT T1AY YHIGHEST YUNIT XHIGHEST	 This graph shows that T1AY are least T1AY in the XLEAST at YLEAST YUNIT . They are slightly better T1AY in the XTHIRD at YTHIRD YUNIT and better again in the XSECOND at almost YSECOND YUNIT . They are well T1AY at YHIGHEST YUNIT in XHIGHEST .
YLABEL YHIGHEST YUNIT XHIGHEST XLABEL XSECOND YSECONDAPPROX YUNIT XTHIRD YTHIRD YUNIT XLEAST YLEAST YUNIT	 Largest YLABEL at YHIGHEST YUNIT in XHIGHEST XLABEL , then XSECOND at YSECONDAPPROX YUNIT , XTHIRD at YTHIRD YUNIT and XLEAST at only YLEAST YUNIT
T1AY T0AY XHIGHEST YHIGHEST YUNIT T0AY MULHIGHESTLEAST XLEAST YLEAST YUNIT T1AY YLABEL XTHIRD YTHIRD YUNIT XSECOND YSECOND YUNIT	 More T1AY than T0AY are found in XHIGHEST - YHIGHEST YUNIT of all T0AY . This is MULHIGHESTLEAST higher than in XLEAST where only YLEAST YUNIT are T1AY . YLABEL in XTHIRD are also low at YTHIRD YUNIT but higher in XSECOND at YSECOND YUNIT .
YLABEL PLOTTITLE XHIGHEST YLABEL YHIGHEST YUNIT XSECOND YSECOND YUNIT XTHIRD YTHIRDAPPROX YUNIT XLEAST YLABEL YLEAST YUNIT	 This graph shows YLABEL PLOTTITLE . XHIGHEST has a YLABEL of YHIGHEST YUNIT (unclear if this mean 60% of people in law firms are women) . XSECOND shows YSECOND YUNIT , XTHIRD YTHIRDAPPROX YUNIT , and XLEAST have the lowest YLABEL at YLEAST YUNIT .
YLABEL PLOTTITLE XHIGHEST YHIGHEST YUNIT T1AY YSECOND YUNIT XSECOND YTHIRD YUNIT XTHIRD YLEAST YUNIT XLEAST	 This chart shows what YLABEL of PLOTTITLE . The chart shows that in XHIGHEST , YHIGHEST YUNIT of the T1AY , compared to YSECOND YUNIT in XSECOND , YTHIRD YUNIT in XTHIRD and YLEAST YUNIT in XLEAST .
PLOTTITLE XHIGHEST YHIGHEST YUNIT XSECOND YSECONDAPPROX YUNIT XTHIRD YTHIRD YUNIT XLEAST YLEAST YUNIT	 This chart shows PLOTTITLE the highest being XHIGHEST at YHIGHEST YUNIT then XSECOND at just above YSECONDAPPROX YUNIT then XTHIRD at YTHIRD YUNIT then XLEAST at YLEAST YUNIT
YHIGHEST YUNIT T1AY XHIGHEST BARSREST	 There are YHIGHEST YUNIT of T1AY in XHIGHEST , which is more than BARSREST .
YLABEL PLOTTITLE T1AY XHIGHEST YHIGHEST YUNIT YSECOND YUNIT T1AY XSECOND YLEASTAPPROX YUNIT XTHIRD YLEAST YUNIT XLEAST	 The chart shows the YLABEL of PLOTTITLE . It shows us that they are most T1AY within XHIGHEST , at YHIGHEST YUNIT . They are YSECOND YUNIT T1AY within XSECOND , just less than YLEASTAPPROX YUNIT in XTHIRD and only YLEAST YUNIT in XLEAST .
PLOTTITLE YLABEL XHIGHEST YHIGHESTAPPROX YUNIT YLABEL XLEAST YLEAST YUNIT	 This chart shows a PLOTTITLE . \\n From the chart we see that the highest YLABEL is in XHIGHEST at YHIGHESTAPPROX YUNIT . We can see that the lowest YLABEL is in XLEAST at YLEAST YUNIT
PLOTTITLE YLABEL YHIGHEST YUNIT XHIGHEST XSECOND YSECOND YUNIT XTHIRD YTHIRD YUNIT XLEAST YLABEL YLEAST YUNIT	 The graph shows PLOTTITLE . The highest YLABEL of YHIGHEST YUNIT is at XHIGHEST . \\n This is then followed by XSECOND at YSECOND YUNIT . XTHIRD is YTHIRD YUNIT and then XLEAST is the smallest YLABEL at YLEAST YUNIT .
PLOTTITLE COUNT XLABEL BARNAMES YLABEL XLABEL YTHIRD YUNIT XTHIRD YSECONDAPPROX YUNIT XSECOND YHIGHEST YUNIT XHIGHEST YLEAST YUNIT XLEAST	 We have here a bar chart representing PLOTTITLE . \\n It is divided into COUNT XLABEL : BARNAMES . \\n The YLABEL across these XLABEL starts at YTHIRD YUNIT for the XTHIRD , just over YSECONDAPPROX YUNIT for XSECOND , YHIGHEST YUNIT for XHIGHEST and YLEAST YUNIT for XLEAST .
PLOTTITLE XLABEL YLABEL XHIGHEST YHIGHESTAPPROX YUNIT YLABEL BARSREST XSECOND XTHIRD YLABEL YTHIRD YHIGHESTAPPROX YUNIT YLABEL XLEAST YLEASTAPPROX YUNIT	 PLOTTITLE shows what the women really want to do with their lives . The XLABEL with the highest YLABEL is XHIGHEST with around YHIGHESTAPPROX YUNIT of YLABEL . BARSREST like XSECOND and XTHIRD also doing good with YLABEL over YTHIRD but not more than YHIGHESTAPPROX YUNIT with the lowest YLABEL in XLEAST with only YLEASTAPPROX YUNIT
PLOTTITLE XHIGHEST YHIGHEST YUNIT YLABEL XSECOND YSECOND YUNIT XTHIRD YTHIRDAPPROX YUNIT XLEAST YLEAST YUNIT	 This graph shows the PLOTTITLE . XHIGHEST have YHIGHEST YUNIT YLABEL followed by XSECOND with YSECOND YUNIT , XTHIRD with YTHIRDAPPROX YUNIT and XLEAST with YLEAST YUNIT .
YLABEL PLOTTITLE YSECOND YUNIT XSECOND YLEAST YUNIT XLEAST YTHIRD YUNIT XTHIRD YHIGHEST YUNIT XHIGHEST	 This graph shows the YLABEL of PLOTTITLE . \\n YSECOND YUNIT in XSECOND \\n YLEAST YUNIT in XLEAST \\n YTHIRD YUNIT in XTHIRD \\n YHIGHEST YUNIT in XHIGHEST
YLABEL XHIGHEST T1AB BARSREST XLEAST YLEAST YUNIT YLABEL XHIGHEST YHIGHEST YUNIT YLABEL	 YLABEL in the XHIGHEST in T1AB is higher than in BARSREST . Whilst XLEAST had only around YLEAST YUNIT YLABEL , XHIGHEST had around a YHIGHEST YUNIT YLABEL .
PLOTTITLE YLABEL XHIGHEST XSECOND XTHIRD XLEAST	 Here is a chart about PLOTTITLE . The highest with YLABEL is XHIGHEST , followed by XSECOND . XTHIRD is the third highest and XLEAST at the lowest .
PLOTTITLE XTHIRD YTHIRD YUNIT T0AY T0AY XSECOND YLABEL YSECOND YUNIT XHIGHEST YHIGHESTAPPROX YUNIT XLEAST YLABEL YLEASTAPPROX YUNIT	 This chart shows the PLOTTITLE . \\n \\n In XTHIRD , YTHIRD YUNIT of the T0AY were T0AY . In XSECOND , that YLABEL increases to YSECOND YUNIT and also in XHIGHEST which has YHIGHESTAPPROX YUNIT . XLEAST have the lowest YLABEL , at YLEASTAPPROX YUNIT .
PLOTTITLE XHIGHEST YLABEL XSECOND XTHIRD XLEAST XLEAST YLABEL XLABEL YLEAST YUNIT XHIGHEST YHIGHEST YUNIT	 this graph shows PLOTTITLE for example XHIGHEST have more YLABEL than XSECOND , XTHIRD or XLEAST . XLEAST has a very low YLABEL in their XLABEL with on YLEAST YUNIT compared to XHIGHEST YHIGHEST YUNIT
PLOTTITLE XHIGHEST YLABEL COUNT XLABEL XLEAST	 This chart shows the PLOTTITLE . We can see that XHIGHEST have the highest YLABEL out of the COUNT XLABEL and XLEAST has the lowest .
PLOTTITLE YTHIRD XTHIRD YLABEL XSECOND XHIGHEST T1AY XLEAST	 This chart represents the PLOTTITLE . \\n \\n There is YTHIRD in XTHIRD , with a higher YLABEL in XSECOND and XHIGHEST . \\n \\n T1AY appear to be under represented in the XLEAST .
PLOTTITLE COUNT XLABEL XHIGHEST YHIGHEST YUNIT XSECOND YSECOND YUNIT XTHIRD YTHIRD YUNIT YLABEL XLEAST YLEAST YUNIT YLABEL	 The following graph shows the PLOTTITLE , the COUNT XLABEL are XHIGHEST which is the highest with YHIGHEST YUNIT . XSECOND with YSECOND YUNIT , XTHIRD with YTHIRD YUNIT YLABEL and XLEAST with only YLEAST YUNIT YLABEL .
YLABEL PLOTTITLE T1AY T0AY XLEAST YTHIRD YLABEL T0AY T1AY XTHIRD YLABEL XSECOND XHIGHEST	 This chart shows the YLABEL of PLOTTITLE . We can see that there are less T1AY than T0AY working in XLEAST , and an YTHIRD YLABEL of T0AY and T1AY in XTHIRD . However there are a higher YLABEL working in XSECOND and XHIGHEST .
PLOTTITLE YTHIRD YUNIT YLABEL XTHIRD YSECONDAPPROX YUNIT XSECOND YHIGHESTAPPROX YUNIT XHIGHEST	 The chart shows PLOTTITLE . \\n \\n There is YTHIRD YUNIT of YLABEL in the XTHIRD . YSECONDAPPROX YUNIT in XSECOND and YHIGHESTAPPROX YUNIT in XHIGHEST
YLABEL PLOTTITLE XHIGHEST XSECOND XTHIRD XLEAST	 The graph shows the YLABEL of PLOTTITLE . The largest is in XHIGHEST , followed by the XSECOND , then XTHIRD and lastly XLEAST .
PLOTTITLE XHIGHEST YLABEL YHIGHEST YUNIT XLEAST YLEAST YUNIT T1AY	 This chart displays information of PLOTTITLE . XHIGHEST have the highest YLABEL with YHIGHEST YUNIT and XLEAST has the lowest with YLEAST YUNIT of T1AY .
YLABEL PLOTTITLE XTHIRD YLABEL YTHIRD YUNIT XSECOND YLABEL YSECOND YUNIT YLABEL XHIGHEST YHIGHEST YUNIT YLABEL XLEAST YLEAST YUNIT	 This graph shows the YLABEL of PLOTTITLE . In the XTHIRD the YLABEL was YTHIRD YUNIT . In the XSECOND this YLABEL was higher at YSECOND YUNIT . The YLABEL for the XHIGHEST was even higher at YHIGHEST YUNIT though the YLABEL for the XLEAST was lower at YLEAST YUNIT .
